Gg, Gg, Gg, Gg, Gg, Xoc^Efs, Xoc, Xoc, Xoc, Xoc, Xoc^Efs, Xoc, Xoc, Xoc, Xoc, Xoc, Xoc, Xoc, Xoc, Xoc, Xoc, Xoc
Gg, Ce, Ke, Ce, Gg, Xoc^Efs, Xoc, Xoc, Xoc^Efs, Xoc^Efs, Ch, Xoc^Efs, Xoc^Efs, Xoc, Xoc, Xoc, Xoc, Xoc, Xoc, Xoc, Xoc, Xoc
Gg, Ce, Ce, Ce, Gg, Xoc^Efs, Xoc, Xoc, Xoc^Efs, Kh, Ch, Rr, Rr, Xoc^Efs, Xoc^Efs, Xoc, Xoc, Xoc, Xoc, Xoc, Xoc, Xoc
Gg, Rrc, Rrc, Rrc, Rrc, Xoc^Efs, Xoc^Efs, Xoc, Xoc^Efs, Xoc^Efs, Xoc^Efs, Rr, Rr, Rr, Rr, Xoc^Efs, Xoc, Xoc, Xoc, Xoc, Xoc, Xoc
Rrc, Rrc, Rrc, Rrc^Vhc, Rrc, Gg, Gg, Xoc^Efs, Gg^Fds, Xoc^Efs, Gg^Fds, Xoc^Efs, Gg, Rr, Gg, Xoc^Efs, Xoc, Xoc, Xoc, Xoc, Xoc, Xoc
Rrc, Rrc, Rrc^Vhc, Rrc, Rrc, Gg, Rrc, Gg, Rrc, Gg, Rrc, Gg, Rrc, Gg, Gg, Xoc^Efs, Xoc^Efs, Xoc, Xoc, Xoc, Xoc, Xoc
Rrc, Rrc, Rrc, Rrc, Rrc, Rrc, Rrc, Rrc, Rrc, Rrc, Rrc, Rrc, Rrc, Rrc, Rrc, Gg, Gg^Fds, Xoc^Efs, Xoc^Efs, Xoc, Xoc^Efs, Xoc^Efs
Rrc, Rrc, Gg, Gg, Gg, Rrc, Gg, Rrc, Gg^Fds, Rrc, Gg^Fds, Rrc, Gg, Rrc, Rrc, Rrc, Rrc, Gg, Gg, Xoc^Efs, Gg, Gg
Gg, Gg, Gg, Xoc^Efs, Xoc^Efs, Gg^Fds, Xoc^Efs, Gg^Fds, Xoc^Efs, Gg^Fds, Xoc^Efs, Gg^Fds, Xoc^Efs, Gg, Gg^Fds, Rrc, Rrc, Rrc, Rrc, Gg, Rrc, Rrc
Rr, Gg, Rr, Xoc^Efs, Ch, Xoc^Efs, Xoc^Efs, Xoc^Efs, Xoc^Efs, Xoc^Efs, Xoc, Xoc^Efs, Xoc, Xoc^Efs, Xoc^Efs, Gg^Fds, Gg, Rrc, Rrc, Rrc, Rrc, Rrc
Rr, Rr, Rr, Ch, Kh, Ch, Rr, Rr, Rr, Xoc^Efs, Xoc, Xoc, Xoc, Xoc, Xoc, Xoc^Efs, Xoc^Efs, Gg, Rrc, Rrc, Rrc, Rrc
Xoc^Efs, Xoc^Efs, Xoc^Efs, Ch, Xoc^Efs, Ch, Xoc^Efs, Rr, Rr, Xoc^Efs, Xoc^Efs, Xoc, Xoc^Efs, Xoc, Xoc^Efs, Xoc, Xoc^Efs, Gg, Rrc, Rrc^Vhc, Rrc, Rrc
Xoc^Efs, Xoc^Efs, Gg^Fds, Xoc^Efs, Gg^Fds, Xoc^Efs, Xoc^Efs, Rr, Gg, Gg, Gg^Fds, Xoc^Efs, Gg^Fds, Xoc^Efs, Gg^Fds, Xoc^Efs, Gg, Gg, Rrc, Rrc, Rrc, Rrc
Gg, Gg, Gg, Gg^Fds, Gg, Gg, Gg, Gg, Rrc, Gg, Rrc, Gg, Rrc, Gg, Rrc, Gg, Rrc, Rrc, Rrc, Rrc, Rrc, Rrc
Rrc, Rrc, Rrc, Rrc, Rrc, Rrc, Rrc, Rrc, Rrc, Rrc, Rrc, Rrc, Rrc, Rrc, Rrc, Rrc, Rrc, Rrc, Gg, Gg, Gg^Fds, Gg
Rrc, Rrc, Rrc, Rrc, Ch, Ch, Ch, Rrc, Rrc, Rrc, Gg, Rrc, Gg, Rrc, Gg, Rrc, Gg, Gg, Xoc^Efs, Xoc^Efs, Xoc^Efs, Xoc^Efs
Gg, Gg, Ch^Vhc, Rrc, Rrc, Kh, Ch, Rrc, Gg, Gg^Fds, Xoc^Efs, Gg^Fds, Xoc^Efs, Gg^Fds, Xoc^Efs, Gg, Rr, Gg, Rr, Xoc^Efs, Xoc, Xoc
Ww^Bsb/, Ww^Bsb/, Ww, Gg, Ch^Vhc, Rrc, Rrc, Rrc, Gg, Xoc^Efs, Xoc, Xoc^Efs, Xoc^Efs, Xoc^Efs, Rr, Rr, Rr, Rr, Xoc^Efs, Xoc^Efs, Xoc, Xoc
Ww, Ww, Ww^Bsb/, Ww^Bsb/, Ww, Gg, Ch^Vhc, Gg, Gg^Fds, Xoc^Efs, Xoc, Xoc^Efs, Kh, Ch, Ch, Rr, Xoc^Efs, Xoc^Efs, Xoc, Xoc, Xoc, Xoc
Ww, Ww, Ww, Ww, Ww^Bsb/, Ww^Bsb/, Ww, Gg, Gg^Fds, Xoc^Efs, Xoc^Efs, Xoc^Efs, Xoc^Efs, Ch, Xoc^Efs, Xoc^Efs, Xoc, Xoc, Xoc, Xoc, Xoc, Xoc
Ww, Ww, Ww, Ww, Ww, Ww, Ww, Gg, Gg, Gg^Fds, Gg^Fds, Xoc^Efs, Xoc, Xoc^Efs, Xoc, Xoc, Xoc, Xoc, Xoc, Xoc, Xoc, Xoc
Ww, Ww, Ww, Ww, Ww, Ww, Ww, Gg, Gg, Gg^Fds, Gg, Xoc^Efs, Xoc, Xoc, Xoc, Xoc, Xoc, Xoc, Xoc, Xoc, Xoc, Xoc
