Gg, Rrc, Rrc^Vhc, Rrc, Gg^Fds, Xoc^Efs, Xoc, Xoc, Xoc, Xoc, Xoc^Efs, Xoc, Xoc, Xoc, Xoc, Xoc, Xoc, Xoc, Xoc, Xoc, Xoc, Xoc
Gg^Fds, Rrc, Rrc, Rrc, Gg^Fds, Xoc^Efs, Xoc, Xoc, Xoc^Efs, Xoc^Efs, Ch, Xoc^Efs, Xoc^Efs, Xoc, Xoc, Xoc, Xoc, Xoc, Xoc, Xoc, Xoc, Xoc
Ch, Ch, Kh, Ch, Ch, Xoc^Efs, Xoc, Xoc, Xoc^Efs, Kh, Ch, Rr, Rr, Xoc^Efs, Xoc^Efs, Xoc, Xoc, Xoc, Xoc, Xoc, Xoc, Xoc
Gg, Ch, Rrc, Ch, Gg, Xoc^Efs, Xoc^Efs, Xoc, Xoc^Efs, Xoc^Efs, Xoc^Efs, Rr, Rr, Rr, Rr, Xoc^Efs, Xoc, Xoc, Xoc, Xoc, Xoc, Xoc
Rrc, Rrc, Rrc, Rrc, Rrc, Gg^Fds, Gg^Fds, Xoc^Efs, Gg^Fds, Xoc^Efs, Gg^Fds, Xoc^Efs, Gg, Rr, Gg, Xoc^Efs, Xoc, Xoc, Xoc, Xoc, Xoc, Xoc
Rrc, Rrc^Vhc, Rrc, Rrc^Vhc, Rrc, Gg, Rrc, Gg, Rrc, Gg, Rrc, Gg, Rrc, Gg, Gg, Xoc^Efs, Xoc^Efs, Xoc, Xoc, Xoc, Xoc, Xoc
Rrc, Rrc, Rrc, Rrc, Rrc, Rrc, Rrc, Rrc, Rrc, Rrc, Rrc, Rrc, Rrc, Rrc^Vhc, Rrc, Gg, Gg^Fds, Xoc^Efs, Xoc^Efs, Xoc, Xoc^Efs, Xoc^Efs
Gg^Fds, Gg, Gg, Gg, Gg, Rrc, Gg, Rrc, Gg^Fds, Rrc, Gg^Fds, Rrc, Gg, Rrc, Rrc, Rrc, Rrc, Gg, Gg, Xoc^Efs, Gg^Fds, Gg^Fds
Xoc^Efs, Gg, Rr, Xoc^Efs, Xoc^Efs, Gg^Fds, Xoc^Efs, Gg^Fds, Xoc^Efs, Gg^Fds, Xoc^Efs, Gg^Fds, Xoc^Efs, Gg, Gg^Fds, Rrc, Rrc, Rrc, Rrc, Gg, Rrc, Rrc
Xoc^Efs, Rr, Rr, Xoc^Efs, Ch, Xoc^Efs, Xoc^Efs, Xoc^Efs, Xoc^Efs, Xoc^Efs, Xoc, Xoc^Efs, Xoc, Xoc^Efs, Xoc^Efs, Gg^Fds, Gg, Rrc, Rrc, Rrc, Rrc, Rrc^Vhc
Xoc^Efs, Rr, Rr, Ch, Kh, Ch, Rr, Rr, Rr, Xoc^Efs, Xoc, Xoc, Xoc, Xoc, Xoc, Xoc^Efs, Xoc^Efs, Gg, Rrc, Rrc, Rrc, Rrc
Xoc^Efs, Xoc^Efs, Xoc^Efs, Ch, Xoc^Efs, Ch, Xoc^Efs, Rr, Rr, Xoc^Efs, Xoc^Efs, Xoc, Xoc^Efs, Xoc, Xoc^Efs, Xoc, Xoc^Efs, Gg^Fds, Rrc, Rrc^Vhc, Rrc, Rrc
Xoc^Efs, Xoc^Efs, Xoc^Efs, Xoc^Efs, Xoc^Efs, Xoc^Efs, Xoc^Efs, Rr, Gg, Gg, Gg^Fds, Xoc^Efs, Gg^Fds, Xoc^Efs, Gg^Fds, Xoc^Efs, Gg, Gg, Rrc, Rrc, Rrc, Rrc^Vhc
Gg, Gg^Fds, Gg, Gg^Fds, Gg, Gg^Fds, Gg, Gg, Rrc, Gg, Rrc, Gg, Rrc, Gg, Rrc, Gg, Rrc, Rrc, Rrc, Rrc, Rrc, Rrc
Rrc^Vhc, Rrc, Rrc, Rrc, Rrc, Rrc, Rrc, Rrc, Rrc, Rrc, Rrc, Rrc, Rrc, Rrc, Rrc^Vhc, Rrc, Rrc, Rrc, Gg^Fds, Gg, Gg^Fds, Gg
Rrc, Rrc, Rrc, Rrc, Ch, Ch, Ch, Rrc, Rrc, Rrc, Gg, Rrc, Gg, Rrc, Gg, Rrc, Gg, Gg^Fds, Xoc^Efs, Xoc^Efs, Xoc^Efs, Xoc^Efs
Gg, Gg, Ch^Vhc, Rrc, Rrc, Kh, Ch, Rrc, Gg, Gg^Fds, Xoc^Efs, Gg^Fds, Xoc^Efs, Gg^Fds, Xoc^Efs, Gg, Rr, Gg, Rr, Xoc^Efs, Xoc, Xoc
Wwf^Bsb/, Wwf^Bsb/, Wwf, Rrc, Ch^Vhc, Rrc, Rrc, Rrc, Gg, Xoc^Efs, Xoc, Xoc^Efs, Xoc^Efs, Xoc^Efs, Rr, Rr, Rr, Rr, Xoc^Efs, Xoc^Efs, Xoc, Xoc
Ww, Ww, Wwf^Bsb/, Wwf^Bsb/, Wwf, Rrc, Ch^Vhc, Gg, Gg^Fds, Xoc^Efs, Xoc, Xoc^Efs, Kh, Ch, Ch, Rr, Xoc^Efs, Xoc^Efs, Xoc, Xoc, Xoc, Xoc
Ww, Ww, Ww, Ww, Wwf^Bsb/, Wwf^Bsb/, Wwf, Gg, Gg^Fds, Xoc^Efs, Xoc^Efs, Xoc^Efs, Xoc^Efs, Ch, Xoc^Efs, Xoc^Efs, Xoc, Xoc, Xoc, Xoc, Xoc, Xoc
Wo, Ww, Ww, Ww, Ww, Ww, Wwf, Gg, Gg, Gg^Fds, Gg^Fds, Xoc^Efs, Xoc, Xoc^Efs, Xoc, Xoc, Xoc, Xoc, Xoc, Xoc, Xoc, Xoc
Wo, Wo, Ww, Ww, Ww, Ww, Ww, Wwf, Gg, Gg^Fds, Gg, Xoc^Efs, Xoc, Xoc, Xoc, Xoc, Xoc, Xoc, Xoc, Xoc, Xoc, Xoc
