Wo, Wo, Wo, Wo, Wo, Wo, Wo, Wo, Wo, Wo, Wo, Wo, Wo, Wo, Wo, Wo, Wo, Wo, Wo, Wo, Wo, Wo, Wo, Wo, Wo, Wo
Wo, Wo, Wo, Wo, Wo, Wo, Wo, Wo, Wo, Wo, Wo, Wo, Wo, Wo, Wo, Wo, Wo, Wo, Wo, Wo, Wo, Wo, Wo, Wo, Wo, Wo
Wo, Wo, Wo, Wo, Wo, Wo, Wo, Wo, Wo, Wo, Wo, Wo, Wo, Wo, Wo, Wo, Wo, Wo, Wo, Wo, Wo, Wo, Wo, Wo, Wo, Wo
Wo, Wo, Wo, Wo, Wo, Wo, Wo, Wo, Wo, Wo, Wo, Wo, Wo, Wo, Wo, Wo, Ww, Ww, Ww, Wo, Wo, Wo, Wo, Wo, Wo, Wo
Wo, Wo, Wo, Wo, Wo, Wo, Wo, Wo, Wo, Wo, Wo, Wo, Wo, Wo, Ww, Ww, Ce, Ce, Ce, Ww, Ww, Wo, Wo, Wo, Wo, Wo
Wo, Wo, Wo, Wo, Wo, Wo, Wo, Wo, Wo, Wo, Wo, Wo, Ww, Ww, Rd, Re, Re^Vct, Re, Re, Ce, Ww, Wo, Wo, Wo, Wo, Wo
Wo, Wo, Wo, Wo, Wo, Wo, Wo, Wo, Wo, Wo, Ww, Ww, Rd, Rd, Re, Ce, Ket, Ce, Re, Ce, Ww, Wo, Wo, Wo, Wo, Wo
Wo, Wo, Wo, Wo, Wo, Wo, Wo, Wo, Ww, Ww, Rd, Rd, Re, Re, Re, Ce, Ce, Re^Vct, Ce, Ce, Ww, Wo, Wo, Wo, Wo, Wo
Wo, Wo, Wo, Wo, Wo, Wo, Ww, Ww, Rd, Rd, Re, Re, Xom, Re, Re, Re, Rd, Re, Ww, Ww, Wo, Wo, Wo, Wo, Wo, Wo
Wo, Wo, Wo, Wo, Wo, Ww, Ce, Ce, Re, Re, Re, Re, Re, Re, Rd, Rd, Ww^Bw|r, Ww, Wo, Wo, Wo, Wo, Wo, Wo, Wo, Wo
Wo, Wo, Wo, Wo, Wo, Ww, Ce, Re^Vct, Re, Xom, Re, Re, Rd, Rd, Ww^Bw|r, Ww^Bw\r, Ww^Bw|r, Wo, Wo, Wo, Wo, Wo, Wo, Wo, Wo, Wo
Wo, Wo, Wo, Wo, Wo, Ww, Ce, Re, Re^Vct, Re, Rd, Rd, Ww, Ww, Ww^Bw|r, Ww^Bw/r, Ww^Bw|r, Wo, Wo, Wo, Wo, Wo, Wo, Wo, Wo, Wo
Wo, Wo, Wo, Wo, Wo, Ww, Ww, Ce, Ce, Ce, Ww, Ww, Ce, Ww, Ww^Bw|r, Ww^Bw\r, Ww^Bw|r, Wo, Wo, Wo, Wo, Wo, Wo, Wo, Wo, Wo
Wo, Wo, Wo, Wo, Ww, Wo, Wo, Ww, Ww, Ww, Ce, Ce, Re^Vct, Ce, Rd, Ww^Bw/r, Ww^Bw|r, Wo, Wo, Wo, Wo, Wo, Wo, Wo, Wo, Wo
Wo, Wo, Ww, Ww, Ce, Ww, Ww, Wo, Wo, Ww, Ce, Re, Re, Re, Re, Rd, Rd, Ww, Ww, Wo, Wo, Wo, Wo, Wo, Wo, Wo
Wo, Ww, Ce, Ce, Re, Ce, Ce, Ww, Wo, Ww, Ce, Re^Vct, Re, Xom, Re, Re, Re, Rd, Rd, Ww, Ww, Wo, Wo, Wo, Wo, Wo
Wo, Ww, Ce, Re^Vct, Re, Re^Vct, Ce, Ww, Wo, Ww, Ww^Bw/r, Ce, Rd, Re, Re, Re, Xom, Re, Re, Rd, Re, Ww, Ww, Wo, Wo, Wo
Wo, Ww, Rd, Re, Xom, Re, Rd, Ww, Ww^Bw/r, Ww^Bw/r, Ww^Bw\r, Ww^Bw|r, Ww^Bw/r, Rd, Rd, Re, Re, Re, Ce, Ce, Re^Vct, Ce, Ce, Ww, Wo, Wo
Wo, Ww, Rd, Re, Re, Re, Rd, Ww^Bw/r, Ww^Bw|r, Ww, Ww^Bw/r, Ww^Bw/r, Wo, Ww, Ww, Rd, Rd, Re, Ce, Ket, Ce, Re, Ce, Ww, Wo, Wo
Wo, Ww, Rd, Re, Ce, Re, Rd, Ww^Bw\r, Ww^Bw/r, Ww^Bw/r, Wo, Wo, Wo, Wo, Wo, Ww, Ww, Rd, Re, Re^Vct, Re, Re, Ce, Ww, Wo, Wo
Wo, Ww, Re, Ce, Ket, Ce, Re, Ww^Bw/r, Wo, Wo, Wo, Wo, Wo, Wo, Wo, Wo, Wo, Ww, Ww, Ce, Ce, Ce, Ww, Ww, Wo, Wo
Wo, Ww, Ce, Re^Vct, Ce, Re^Vct, Ce, Ww, Wo, Wo, Wo, Wo, Wo, Wo, Wo, Wo, Wo, Wo, Wo, Ww, Ww, Ww, Wo, Wo, Wo, Wo
Wo, Ww, Ce, Re, Re, Re, Ce, Ww, Wo, Wo, Wo, Wo, Wo, Wo, Wo, Wo, Wo, Wo, Wo, Wo, Wo, Wo, Wo, Wo, Wo, Wo
Wo, Ww, Ww, Ce, Ce, Ce, Ww, Ww, Wo, Wo, Wo, Wo, Wo, Wo, Wo, Wo, Wo, Wo, Wo, Wo, Wo, Wo, Wo, Wo, Wo, Wo
Wo, Wo, Wo, Ww, Ww, Ww, Wo, Wo, Wo, Wo, Wo, Wo, Wo, Wo, Wo, Wo, Wo, Wo, Wo, Wo, Wo, Wo, Wo, Wo, Wo, Wo
Wo, Wo, Wo, Wo, Wo, Wo, Wo, Wo, Wo, Wo, Wo, Wo, Wo, Wo, Wo, Wo, Wo, Wo, Wo, Wo, Wo, Wo, Wo, Wo, Wo, Wo
Wo, Wo, Wo, Wo, Wo, Wo, Wo, Wo, Wo, Wo, Wo, Wo, Wo, Wo, Wo, Wo, Wo, Wo, Wo, Wo, Wo, Wo, Wo, Wo, Wo, Wo
