Hh, Hh, Hh, Hh, Gll^Fp, Hh, Gll^Fp, Gd, Gs, Gs, Gd, Gll^Fp, Hh, Gll^Fp, Gll^Fp, Hh, Hh, Hh, Hh, Gll^Fp, Gll^Fp, Hh, Gll^Fp, Gll^Fp, Gd, Gd, Gd, Gll^Fp, Gll^Fp, Gll^Fp, Hh, Hh, Hh, Hh
Gd, Hh, Gll^Fp, Hh, Gs, Gll^Fp, Gd, Gd, Gd^Vo, Gd, Gll^Fp, Gll^Fp, Hh, Hh, Gll^Fp, Gll^Fp, Hh, Hh, Gll^Fp, Hh, Gll^Fp, Gll^Fp, Gll^Fp, Gd, Gs, Gs, Gd, Gll^Fp, Gll^Fp, Hh, Gll^Fp, Hh, Gll^Fp, Hh
Ss, Gs, Gs, Gs, Gd, Gs, Gd, Gd, Gd, Gd, Gll^Fp, Hh, Hh, Gll^Fp, Gll^Fp, Hh, Gll^Fp, Hh, Gll^Fp, Hh, Gll^Fp, Gd, Gs, Gd, Chr, Gs, Gs, Gd, Gd, Gll^Fp, Hh, Hh, Gll^Fp, Hh
Ww, Ww, Ss, Ss, Ss, Gd^Vo, Ss, Gd, Gs, Gd, Gd, Gll^Fp, Gd, Gd, Gd, Gll^Fp, Gd, Gll^Fp, Gd, Gll^Fp, Gs, Gs, Rp, Chr, Gs, Rp, Rp, Chr, Gd, Gll^Fp, Gll^Fp, Gll^Fp, Hh, Hh
Wo, Ww, Ww, Ww, Ww, Ww, Ss, Gd, Gd, Gs, Gs, Gd, Gd, Gd^Vo, Gd, Gd, Gs, Gd, Gs, Gs, Gs, Rp, Gs, Gs, Gd, Gd, Gll^Fp, Gd, Gd, Gll^Fp, Gd, Gll^Fp, Gll^Fp, Gll^Fp
Ww, Ww, Ww, Wo, Wo, Ww, Ww, Ss, Gd, Gs, Gs, Gs, Rp, Gs, Gs, Gs, Rp, Gs, Rp, Rp, Khr, Rp, Rp, Rp^Vhcr, Gs, Gs, Gd, Gd, Gs, Gd, Chr, Gd, Gd, Gd
Ss, Ss, Ww, Wo, Wo, Wo, Ww, Ss, Wwr, Ss, Wwr, Rp, Gs, Rp, Gd, Gs, Gs, Rp, Gd, Chr, Gd, Rp, Gs, Rp, Chr, Rp, Gs, Rp^Vhcr, Rp, Rp, Gd, Gd, Gd, Gll^Fp
Gd, Gd, Gd, Ww, Ww, Ww, Ww, Ww, Wwr, Chw, Wwr, Chw, Ww, Ss, Ww, Gd, Gd, Gll^Fp, Gll^Fp, Gd, Gll^Fp, Gd, Rp^Vhcr, Rp, Rp, Chr, Rp, Rp, Gs, Gd, Gs, Gd, Gd, Gd
Gll^Fp, Gll^Fp, Gd^Vo, Ss, Gd, Ss, Chw, Wwr, Chw, Wwr, Ww, Ww, Wo, Ww, Ww, Ss, Gd, Gll^Fp, Hh, Hh, Gll^Fp, Gll^Fp, Gd, Gs, Chr, Khr, Chr, Chr, Gs, Rp^Vhcr, Gd, Gll^Fp, Gs, Chr
Gll^Fp, Gll^Fp, Gll^Fp, Gd, Gs, Chr, Khr, Wwr, Wwr, Wwr, Ww, Wo, Wo, Wo, Wo, Ww, Ss, Gll^Fp, Gll^Fp, Gll^Fp, Gll^Fp, Gd, Gll^Fp, Rp, Rp, Rp, Chr, Rp, Rp, Rp, Gll^Fp, Gd, Rp^Vhcr, Rp
Gll^Fp, Hh, Gll^Fp, Gs, Rp, Chr, Rp, Chr, Ss, Ww, Ww, Wo, Wo, Wo, Wo, Ww, Ss, Gd, Gd, Gll^Fp, Gd, Gd, Gd, Gs, Rp, Gs, Rp, Gs, Rp, Gs, Gs, Gs, Rp, Gs
Gd, Gll^Fp, Gll^Fp, Gd, Gs, Rp, Gs, Gs, Gd, Ss, Ww, Wo, Ww, Wo, Ww, Ww, Ww, Ww, Ww, Ss, Ss, Ss, Ss, Rp, Gs, Rp^Vhcr, Rp, Gs, Gs, Rp^Vhcr, Rp, Rp, Gs, Gs
Gs, Gd, Gd, Gd, Gd^Vo, Gd, Gll^Fp, Gd, Gll^Fp, Ss, Ss, Ww, Ss, Ww, Ww, Wo, Wo, Wo, Wo, Ww, Wwr, Chw, Wwr, Rp, Chw, Ss, Ss, Rp, Chr, Rp, Khw, Chr, Ss, Ss
Gs, Gs, Gs, Gs, Gs, Gd, Gll^Fp, Hh, Hh, Gd, Gd, Ss, Gd, Ss, Ww, Wo, Ww, Wo, Ww, Ww, Wwr, Wwr, Chw, Wwr, Ww, Ww, Ww, Chw, Ww, Chw, Ww^Bw|r, Chw, Ww, Ww
Gs, Gd^Vo, Gd, Gs, Gs, Gd, Gll^Fp, Gll^Fp, Hh, Gll^Fp, Gll^Fp, Gll^Fp, Gll^Fp, Ss, Ss, Ww, Ss, Ww, Ss, Wwr, Chw, Wwr, Wwr, Wwr, Ww, Wo, Wo, Ww, Wo, Ww, Ww, Ww, Ww, Ww
Gd, Gd, Gll^Fp, Gs, Gd, Gd, Gd, Gll^Fp, Hh, Hh, Hh, Gll^Fp, Hh, Gll^Fp, Gd, Ss, Gll^Fp, Gd, Rp, Chr, Rp, Wwr, Ww, Ww, Wo, Wo, Wo, Wo, Wo, Wo, Wo, Wo, Wo, Wo
Gll^Fp, Gd, Gll^Fp, Gd, Gll^Fp, Gd, Gd, Gll^Fp, Gll^Fp, Gll^Fp, Gll^Fp, Hh, Gll^Fp, Gll^Fp, Gll^Fp, Gll^Fp, Gll^Fp, Gs, Gs, Gs, Gd, Ss, Ss, Ww, Ww, Wo, Ww, Wo, Wo, Wo, Wo, Wo, Wo, Wo
Hh, Gll^Fp, Hh, Gll^Fp, Gll^Fp, Gd, Ce, Gd, Gs, Gd, Gd, Gd, Gd, Gll^Fp, Gd, Gd, Gd, Gd, Gs, Hh, Gs, Gd, Gd, Gd, Ss, Ww, Ss, Ww, Ww, Ww, Ww, Wo, Wo, Wo
Hh, Hh, Hh, Gll^Fp, Gd, Gd, Gd, Re, Re, Gd, Gd^Vo, Gd, Ce, Gd, Gs, Gs, Gd, Gll^Fp, Gd, Hh, Hh, Hh, Hh, Gd, Gd, Ss, Gd, Ss, Ss, Ww, Ww, Ww, Wo, Wo
Hh, Gll^Fp, Gll^Fp, Gll^Fp, Gll^Fp, Gd, Gd^Vo, Gs, Re, Ce, Re, Gd, Re, Re, Ce, Gd, Gll^Fp, Gll^Fp, Gll^Fp, Gll^Fp, Gll^Fp, Mm, Mm, Hh, Gs, Gd, Gs, Gd, Gd, Gd, Ss, Ww, Ww, Wo
Gll^Fp, Gll^Fp, Gd, Gll^Fp, Gd, Gd, Gd, Re, Re, Ce, Ce, Re, Gs, Gd, Gd^Vo, Gd, Gll^Fp, Hh, Hh, Hh, Gll^Fp, Hh, Mm, Mm, Hh, Gs, Gs, Gd, Gd^Vo, Gd, Gd, Ss, Ww, Ww
Gd, Gll^Fp, Gd, Ce, Re, Gs, Re, Ce, Ce, Ket, Ce, Re, Re, Gs, Gd, Gd, Gd, Gll^Fp, Gd, Gll^Fp, Gd, Gs, Hh, Mm, Mm, Hh, Hh, Hh, Hh, Gd, Gd, Ss, Ss, Ss
Gs, Gs, Gs, Gs, Gs, Re, Gs, Re, Re, Re, Re, Re, Ce, Gs, Gs, Gll^Fp, Gll^Fp, Gd, Gd, Gd, Gd^Vo, Gs, Gs, Hh, Hh, Hh, Mm, Mm, Mm, Hh, Gs, Gd, Gd, Gd
Gll^Fp, Gs, Gd^Vo, Gs, Gd, Ce, Gd, Gs, Gd, Gd, Gd, Gd, Gd, Gd, Gd, Gll^Fp, Gd, Gs, Gs, Gs, Gs, Gs, Gs, Gll^Fp, Gll^Fp, Hh, Hh, Mm, Hh, Hh, Hh, Gll^Fp, Gll^Fp, Gd
Gll^Fp, Gd, Gd, Gd, Gd, Gd, Gll^Fp, Gll^Fp, Gd, Gd^Vo, Gd, Gd, Gll^Fp, Gll^Fp, Gd, Gd, Gd, Gd, Gd, Gd, Gd, Gs, Gd, Gd, Gll^Fp, Hh, Hh, Hh, Mm, Mm, Mm, Hh, Hh, Gll^Fp
Gd, Gd, Gll^Fp, Gd, Gd, Gd, Gd, Gll^Fp, Gll^Fp, Gd, Gll^Fp, Gd, Gll^Fp, Gll^Fp, Gll^Fp, Gll^Fp, Gll^Fp, Gll^Fp, Gd, Gd^Vo, Gd, Gd, Gd^Vo, Gd, Gd, Gll^Fp, Hh, Mm, Mm, Mm, Mm, Mm, Hh, Gll^Fp
Gll^Fp, Gll^Fp, Gll^Fp, Gd, Gll^Fp, Gd^Vo, Gd, Gll^Fp, Gll^Fp, Gll^Fp, Hh, Gll^Fp, Gll^Fp, Hh, Hh, Hh, Gll^Fp, Gd, Gll^Fp, Gd, Gll^Fp, Gd, Gd, Gd, Gll^Fp, Gll^Fp, Hh, Mm, Mm, Mm, Mm, Mm, Hh, Hh
Gll^Fp, Hh, Hh, Gll^Fp, Gs, Gd, Gd, Gd, Gll^Fp, Gll^Fp, Hh, Hh, Hh, Hh, Gll^Fp, Hh, Hh, Gll^Fp, Hh, Gll^Fp, Gll^Fp, Gll^Fp, Gs, Gd, Gd, Gll^Fp, Gll^Fp, Hh, Hh, Mm, Gs, Hh, Hh, Hh
