Hh, Hh, Hh, Hh, Gs^Fp, Hh, Gs^Fp, Gd, Gd, Gd, Gd, Gs^Fp, Hh, Gs^Fp, Gs^Fp, Hh, Hh, Hh, Hh, Gs^Fp, Gs^Fp, Hh, Gs^Fp, Gd, Gd, Rp, Gd, Gd, Gs^Fp, Gs^Fp, Hh, Hh, Hh, Hh
Gd, Hh, Gs^Fp, Hh, Gd, Gs^Fp, Gd, Gd, Gs^Vo, Gd, Gs^Fp, Gs^Fp, Hh, Hh, Gs^Fp, Gs^Fp, Hh, Hh, Gs^Fp, Hh, Gs^Fp, Gs^Fp, Gd, Gd, Gs, Rp, Gd, Gd, Gs^Fp, Hh, Gs^Fp, Hh, Gs^Fp, Hh
Ss, Gd, Gd, Gd, Gd, Gd, Gd, Gd, Gd, Gd, Gs^Fp, Hh, Hh, Gs^Fp, Gs^Fp, Hh, Gs^Fp, Hh, Gs^Fp, Hh, Gs^Fp, Gd, Gd, Gd, Chr, Rp, Gs, Gd, Gd, Gs^Fp, Hh, Hh, Gs^Fp, Hh
Ww, Ww, Ss, Ss, Ss, Gs^Vo, Ss, Gd, Gs, Gd, Gd, Gs^Fp, Gd, Gd, Gd, Gs^Fp, Gd, Gs^Fp, Gd, Gs^Fp, Gd, Gd, Rp, Chr, Gs, Rp, Rp, Chr, Gd, Gs^Fp, Gs^Fp, Gs^Fp, Hh, Hh
Wo, Ww, Ww, Ww, Ww, Ww, Ss, Gd, Gd, Gs, Gs, Gd, Gs, Gs^Vo, Gd, Gd, Gs, Gd, Gs, Gs, Gs, Rp, Gs, Gs, Gs, Gs, Rp, Gs, Gd, Gs^Fp, Gd, Gs^Fp, Gs^Fp, Gs^Fp
Ww, Ww, Ww, Wo, Wo, Ww, Ww, Ss, Gd, Gs, Gs, Gs, Rp, Gs, Gs, Gs, Rp, Gs, Rp, Rp, Khr, Rp, Rp, Rp^Vhcr, Gs, Rp, Gs, Gs, Gs, Gd, Chr, Gd, Gd, Gd
Ss, Ss, Ww, Wo, Wo, Wo, Ww, Ss, Wwf, Ss, Wwf, Rp, Gs, Rp, Gs, Gs, Gs, Rp, Gd, Chr, Gd, Rp, Gs, Rp, Chr, Rp, Gs, Rp^Vhcr, Rp, Rp, Gd, Gd, Gd, Gs^Fp
Gd, Gd, Gd, Ww, Ww, Ww, Ww, Ww, Wwf, Chw, Wwf, Chw, Ww, Gs, Ww, Gs, Gd, Gs^Fp, Gs^Fp, Gd, Gs^Fp, Gd, Rp^Vhcr, Rp, Rp, Chr, Rp, Rp, Gs, Gs, Gs, Gd, Rp, Gd
Gs^Fp, Gs^Fp, Gs^Vo, Ss, Gd, Ss, Chw, Wwf, Chw, Wwf, Ww, Ww, Wo, Ww, Ww, Ss, Gd, Gs^Fp, Hh, Hh, Gs^Fp, Gs^Fp, Gd, Gs, Chr, Khr, Chr, Chr, Gs, Rp^Vhcr, Rp, Rp, Gs, Chr
Gs^Fp, Gs^Fp, Gs^Fp, Gd, Gd, Chr, Khr, Wwf, Wwf, Wwf, Ww, Wo, Wo, Wo, Wo, Ww, Ss, Gs^Fp, Gs^Fp, Gs^Fp, Gs^Fp, Gd, Rp, Rp, Rp, Rp, Chr, Rp, Rp, Rp, Rp^Vhcr, Gs, Rp^Vhcr, Rp
Gs^Fp, Hh, Gs^Fp, Gd, Rp, Chr, Rp, Chr, Ss, Ww, Ww, Wo, Wo, Wo, Wo, Ww, Ss, Gd, Gd, Gs^Fp, Gd, Gd, Rp, Gs, Gs, Gs, Rp, Gs, Rp, Gs, Gs, Gs, Rp, Gs
Gd, Gs^Fp, Gs^Fp, Gd, Gs, Rp, Gd, Gd, Gd, Ss, Ww, Wo, Ww, Wo, Ww, Ww, Ww, Ww, Ww, Ww, Ss, Chr, Ss, Rp, Wwf, Rp, Rp^Vhcr, Gs, Gs, Rp, Rp, Rp, Gs, Gs
Gs, Gd, Gd, Gd, Gs^Vo, Gd, Gs^Fp, Gd, Gs^Fp, Ss, Ss, Ww, Ss, Ww, Ww, Wo, Wo, Wo, Wo, Ww, Wwf, Ss, Wwf, Chw, Wwf, Ss, Ss, Rp, Chr, Rp, Khw, Chr, Ss, Ss
Gs, Gs, Gs, Gs, Gs, Gd, Gs^Fp, Hh, Hh, Gd, Gd, Ss, Gd, Ss, Ww, Wo, Ww, Wo, Chw, Ww, Wwf, Wwf, Wwf, Ss, Wwf, Chw, Ww, Chw, Ww, Chw, Ww, Chw, Ww, Ww
Gs, Gs^Vo, Gs, Gs, Rb, Gd, Gs^Fp, Gs^Fp, Hh, Gs^Fp, Gs^Fp, Gs^Fp, Gs^Fp, Ss, Ss, Ww, Ss, Ww, Wwf, Wwf, Wwf, Chw, Wwf, Ww, Ww, Ww, Wo, Ww, Wo, Ww, Ww, Ww, Ww, Ww
Gd, Gd, Gd, Gd, Rb, Gd, Gd, Gs^Fp, Hh, Hh, Hh, Gs^Fp, Hh, Gs^Fp, Gd, Ss, Gs^Fp, Gd, Gs, Chw, Gd, Wwf, Ww, Ww, Wo, Wo, Wo, Wo, Wo, Wo, Wo, Wo, Wo, Wo
Gs^Fp, Gd, Gs^Fp, Gd, Gd, Rb, Gd, Gs^Fp, Gs^Fp, Gs^Fp, Gs^Fp, Hh, Gs^Fp, Gs^Fp, Gs^Fp, Gs^Fp, Gs^Fp, Gs, Gs, Gs, Gd, Ss, Ss, Ww, Ww, Wo, Ww, Wo, Wo, Wo, Wo, Wo, Wo, Wo
Hh, Gs^Fp, Hh, Gs^Fp, Gd, Rb, Co, Gd, Gd, Gd, Gd, Gd, Gd, Gs^Fp, Gd, Gd, Gd, Gd, Gd, Hh, Gd, Gd, Gd, Gd, Ss, Ww, Ss, Ww, Ww, Ww, Ww, Wo, Wo, Wo
Hh, Hh, Hh, Gs^Fp, Gd, Gs, Gs, Rb, Gd, Gs, Rb^Vo, Gs, Co, Gd, Rb, Rb, Gd, Gs^Fp, Gd, Hh, Hh, Hh, Hh, Gd, Gd, Ss, Gd, Ss, Ss, Ww, Ww, Ww, Wo, Wo
Hh, Gs^Fp, Gs^Fp, Gs^Fp, Gd, Gs, Rb^Vo, Rb, Rb, Co, Rb, Gd, Rb, Gs, Co, Gd, Gs^Fp, Gs^Fp, Gs^Fp, Gs^Fp, Gs^Fp, Mm, Mm, Hh, Gd, Gd, Gd, Gd, Gd, Gd, Ss, Ww, Ww, Wo
Gs^Fp, Gs^Fp, Gd, Gd, Rb, Gs, Rb, Gd, Rb, Co, Co, Rb, Gd, Rb, Gs, Gd, Gs^Fp, Hh, Hh, Hh, Gs^Fp, Hh, Mm, Mm, Hh, Gd, Gd, Gd, Gs^Vo, Gd, Gd, Ss, Ww, Ww
Gd, Gd, Gs, Co, Gs, Rb, Gd, Co, Co, Ko, Co, Gd, Gd, Rb^Vo, Gs, Gd, Gd, Gs^Fp, Gd, Gs^Fp, Gd, Gd, Hh, Mm, Mm, Hh, Hh, Hh, Hh, Gd, Gd, Ss, Ss, Ss
Gs, Gs, Rb^Vo, Rb, Gs, Gs, Rb, Rb, Gd, Rb, Rb, Rb, Co, Rb, Rb, Gs, Rb^Vo, Gd, Gs, Gd, Gs, Gd, Gd, Hh, Hh, Hh, Mm, Mm, Mm, Hh, Gd, Gd, Gd, Gd
Rb, Rb, Gs, Gs, Rb^Vo, Gs, Co, Gd, Gd, Gd, Rb^Vo, Gd, Gd, Gd, Gd, Rb, Gs, Rb, Rb, Rb^Vo, Rb, Gs, Gs, Gd, Gs^Fp, Hh, Hh, Mm, Hh, Hh, Hh, Gs^Fp, Gs^Fp, Gd
Gs, Gs, Gd, Gs, Gs, Rb, Gd, Gd, Gd, Gd, Gd, Gd, Gs^Fp, Gs^Fp, Gd, Gd, Gd, Gd, Gd, Gs, Gs, Rb, Gs, Gd, Gs^Fp, Hh, Hh, Hh, Mm, Mm, Mm, Hh, Hh, Gs^Fp
Gd, Gd, Gs^Fp, Gd, Gd, Gs, Gd, Gs^Fp, Gs^Fp, Gd, Gs^Fp, Gd, Gs^Fp, Gs^Fp, Gs^Fp, Gs^Fp, Gs^Fp, Gs^Fp, Gd, Gs, Gd, Rb^Vo, Gs, Gd, Gd, Gs^Fp, Hh, Mm, Mm, Mm, Mm, Mm, Hh, Gs^Fp
Gs^Fp, Gs^Fp, Gs^Fp, Gd, Gs^Fp, Gd, Gd, Gs^Fp, Gs^Fp, Gs^Fp, Hh, Gs^Fp, Gs^Fp, Hh, Hh, Hh, Gs^Fp, Gd, Gs^Fp, Gd, Gs^Fp, Gd, Gd, Gd, Gs^Fp, Gs^Fp, Hh, Mm, Mm, Mm, Mm, Mm, Hh, Hh
Gs^Fp, Hh, Hh, Gs^Fp, Gs, Gd, Gd, Gd, Gs^Fp, Gs^Fp, Hh, Hh, Hh, Hh, Gs^Fp, Hh, Hh, Gs^Fp, Hh, Gs^Fp, Gs^Fp, Gs^Fp, Gs, Gd, Gd, Gs^Fp, Gs^Fp, Hh, Hh, Mm, Gs, Hh, Hh, Hh
