Gg, Gs^Fp, Gg, Gs^Fp, Gs^Fp, Gs^Fp, Gs^Fp, Gs^Fp, Gs^Fp, Gs^Fp, Gg, Gg, Ss, Gg, Gg, Gs^Fp, Gs^Fp, Gs^Fp, Gs^Fp, Gs^Fp, Gs^Fp, Gs^Fp, Gs^Fp, Gs^Fp, Gs^Fp, Gs^Fp, Gg, Re, Gs^Fp, Gs^Fp, Gg, Gs^Fp, Gs^Fp, Gs^Fp, Gs^Fp, Gs^Fp, Gs^Fp, Gs^Fp, Gs^Fp, Gs^Fp, Gs^Fp, Re, Gs^Fp, Gg
Gg, Gg, Gg^Ve, Gg, Gs^Fp, Gs^Fp, Gs^Fp, Gs^Fp, Gs^Fp, Gs^Fp, Gs^Fp, Gg, Ss, Ds, Gg, Gs^Fp, Gs^Fp, Gs^Fp, Gs^Fp, Gs^Fp, Gs^Fp, Gs^Fp, Gs^Fp, Gs^Fp, Gs^Fp, Gg, Ce, Re, Gg, Gs^Fp, Gg, Gs^Fp, Gs^Fp, Gs^Fp, Gs^Fp, Gs^Fp, Gs^Fp, Gs^Fp, Gs^Fp, Gs^Fp, Gs^Fp, Re, Gs^Fp, Gs^Fp
Ds, Gg, Gg, Gg, Gg, Gs^Fp, Gs^Fp, Gs^Fp, Gs^Fp, Gs^Fp, Gs^Fp, Ds, Ss, Ss, Ss, Gg, Gs^Fp, Gs^Fp, Gg, Gs^Fp, Gg, Gs^Fp, Gg, Gs^Fp, Gg, Re, Ce, Ce, Gg, Gg, Re, Gg, Gs^Fp, Gs^Fp, Gs^Fp, Gs^Fp, Gs^Fp, Gs^Fp, Re, Gs^Fp, Re, Re, Gs^Fp, Gs^Fp
Ds, Ds, Gg, Gs^Fp, Gs^Fp, Gs^Fp, Gs^Fp, Gs^Fp, Gg, Gg, Gg, Gg, Ds, Gg, Gg, Gg, Gg, Gg, Gs^Fp, Gg, Gs^Fp, Gg, Gg^Ve, Gg, Re, Ce, Gg, Ke, Ce, Re, Gg^Ve, Re, Re, Gg, Gg, Gs^Fp, Re, Re, Gs^Fp, Re, Gs^Fp, Gs^Fp, Gs^Fp, Gs^Fp
Ww, Ds, Gg, Gs^Fp, Gg, Gs^Fp, Gg, Gs^Fp, Gg, Gs^Fp, Ds, Gg, Gg, Ss, Gg, Ss, Ss, Ds, Gs^Fp, Gs^Fp, Ss, Ds, Gg, Gg, Re, Gg, Gg, Ce, Ss, Gg, Ds, Gg, Gg, Re, Re, Re, Gs^Fp, Gs^Fp, Gs^Fp, Gs^Fp, Gs^Fp, Gs^Fp, Gs^Fp, Gs^Fp
Ww, Ds, Ds, Gg, Ds, Gg^Ve, Gs^Fp, Gg, Ds, Gs^Fp, Ss, Ss, Ds, Gg, Ds, Ss, Gs^Fp, Ss, Ss, Ss, Ds, Ss, Gg, Re, Mm, Re, Gg, Ds, Ss, Ss, Ss, Ss, Ds, Gg, Re, Gg, Gg, Gs^Fp, Gg, Gs^Fp, Gs^Fp, Gs^Fp, Gs^Fp, Gg
Ds, Ds, Gg, Gg, Gs^Fp, Ss, Ss, Gg, Gg, Ss, Ss, Gs^Fp, Gs^Fp, Ss, Gs^Fp, Gg, Ds, Gs^Fp, Ss, Ds, Mm, Hh, Hh, Ch, Hh, Ch, Hh, Gg, Hh, Gg, Gs^Fp, Ss, Ss, Ss, Gg, Re, Gg, Gg, Gg, Gg, Gg, Gg, Gg, Gg
Ds, Ds, Gg, Gg, Ds, Ss, Gs^Fp, Ds, Gg, Ds, Ss, Gs^Fp, Ds, Ss, Gg, Ds, Ds, Ss, Ds, Hh, Ww, Ds, Ww, Ww^Bsb|, Ww, Ww^Bsb|, Ww, Ds, Ww, Ss, Ss, Gg, Ds, Gg, Gg, Re, Gg^Ve, Gg, Gg, Gg^Ve, Ds, Gg, Ww, Ww
Ww, Ds, Ds, Gg, Gg, Gs^Fp, Ss, Gs^Fp, Gg, Gs^Fp, Ss, Ss, Ss, Gg, Ss, Gs^Fp, Gg, Ss, Ww, Ww, Ww, Ww, Ww, Wwr, Ww, Ww^Bsb|, Ww, Ww, Ww, Ww, Ww, Hh, Hh, Mm, Re, Re, Gg, Ds, Ww, Ww, Ww, Ww, Wo, Ww
Wo, Ww, Ww, Ds, Ds, Gg, Ds, Ss, Gg, Ds, Ss, Gs^Fp, Gg, Ds, Ss, Ds, Ww, Ww, Ww, Ww, Ww, Ww, Ww, Wwr, Ww, Wwr, Ww, Ww, Ww, Ww, Ww, Ww, Ww^Bsb/, Ch, Hh, Re, Hh, Ds, Ww, Ww, Wo, Ww, Wo, Wo
Wo, Wo, Ww, Ds, Ds, Gg, Gg, Gs^Fp, Gg, Gs^Fp, Ds, Gg, Ds, Ss, Ww, Ww, Ww, Ww, Ww, Ww, Ww, Ww, Hh, Ww^Bsb|, Ww, Ww^Bsb|, Ww, Ww, Ww, Ww, Ww^Bsb/, Wwr, Ww, Ww, Ww^Bsb/, Ch, Ww, Ww, Ww, Wo, Wo, Wo, Wo, Wo
Wo, Ww, Ww, Ww, Ww^Bw/, Gg^Ve, Gg, Gg, Gg, Gg, Gg^Ve, Gg, Ww, Ww, Wo, Wo, Wo, Wo, Ww, Ww, Hh, Hh, Mm, Ww^Bsb|, Mm, Ww^Bsb|, Hh, Ww, Ww^Bsb/, Wwr, Ww, Ww, Wwr, Ww^Bsb/, Ww, Ww, Ww, Ww, Ww, Wo, Wo, Wo, Wo, Wo
Wo, Wo, Wo, Wo, Ww, Ds, Ds, Gg, Gg, Gg, Hh, Ww^Bw\, Ww, Wo, Wo, Wo, Ww, Ww, Ww, Ww, Mm, Mm, Gg, Ch, Mm, Ch, Ch, Ww^Bsb/, Hh, Ww, Ww^Bsb/, Ww^Bsb/, Ww, Ww, Ww, Ww, Wo, Wo, Wo, Wo, Wo, Wo, Wo, Wo
Wo, Wo, Wo, Wo, Wo, Ww, Ww, Gg^Ve, Ds, Ds, Ww, Ww, Wo, Wo, Wo, Ww, Ww, Ww, Hh, Hh, Rr, Gg^Fds, Rr^Vhc, Gg, Gg^Fds, Gg, Rr, Mm, Ch, Ww^Bsb/, Hh, Ww, Ww, Ww, Ww, Ww, Wo, Wo, Wo, Wo, Wo, Wo, Ww, Ww
Wo, Wo, Wo, Wo, Ww, Ww, Ww, Ww^Bw|, Ww, Ww, Ww, Ww, Wo, Wo, Ww, Ww, Ww, Hh, Mm, Rr^Vhc, Rr, Gg, Rr, Rr, Rr, Rr, Rr^Vhc, Rr, Gg^Fds, Mm, Hh, Hh, Hh, Hh, Hh, Ww, Ww, Wo, Ww, Wo, Wo, Wo, Ww, Ww
Wo, Wo, Wo, Wo, Wo, Wo, Ww, Ww, Wo, Ww, Ww, Wo, Wo, Wo, Ww, Ww, Ww, Hh, Mm, Gg, Gg^Fds, Rr, Gg, Gg^Fds, Gg, Gg^Fds, Gg, Rr, Rr, Mm, Mm, Mm, Mm, Mm, Mm, Hh, Hh, Ww, Wo, Wo, Wo, Ww, Ww, Ds
Wo, Wo, Wo, Wo, Wo, Wo, Wo, Ww, Wo, Wo, Wo, Wo, Wo, Ww, Ww, Ww, Ww, Ww, Hh, Rr^Vhc, Rr, Rr, Rr^Vhc, Rr, Rr, Ch, Ch, Ch, Gg, Rr, Rr, Gg, Gg^Fds, Mm, Mm, Mm, Hh, Ww, Ww, Wo, Ww, Ww, Ds, Ds
Wo, Wo, Wo, Wo, Wo, Wo, Wo, Wo, Wo, Wo, Wo, Wo, Wo, Wo, Ww, Ww, Ds, Ww, Ww, Rr, Rr, Gg^Fds, Gg^Fds, Gg, Ch, Ch, Kh, Ch, Ch, Gg^Fds, Rr^Vhc, Rr, Rr, Gg, Gg, Mm, Hh, Ww, Ww, Wo, Ww, Ww, Ds, Ds
Wo, Wo, Wo, Wo, Wo, Wo, Wo, Wo, Wo, Wo, Wo, Wo, Wo, Ww, Ww^Bw\, Gg, Gg^Fds, Ds, Ww, Wwf, Ww, Rr, Ch, Gg, Gg^Fds, Ch, Ch, Ch, Gg^Fds, Rr, Gg^Fds, Gg, Rr, Rr^Vhc, Gg, Mm, Mm, Hh, Ww, Wo, Wo, Ww, Ds, Gg
Wo, Wo, Wo, Wo, Wo, Wo, Wo, Wo, Wo, Wo, Wo, Wo, Ww, Ww, Hh, Rr^Vhc, Gg, Gg^Fds, Gg, Gg^Fds, Wwf, Wwf, Ww^Bsb/, Rr, Rr, Ch, Gg, Ch, Rr, Gg, Rr, Gg, Rr, Gg^Fds, Gg, Mm, Hh, Hh, Ww, Wo, Wo, Ww, Ds, Ds
Wo, Wo, Wo, Wo, Wo, Wo, Wo, Wo, Wo, Wo, Wo, Wo, Ww, Ds, Hh, Rr, Rr, Rr, Rr, Gg, Rr, Ww^Bsb/, Ww, Ch, Rr, Gg, Gg^Fds, Gg, Gg, Rr^Vhc, Gg, Rr, Rr^Vhc, Rr, Rr, Rr, Ch, Ww, Ww, Ww, Ww, Ww, Ds, Gg
Wo, Wo, Wo, Wo, Wo, Wo, Wo, Wo, Wo, Wo, Wo, Wo, Ww, Ds, Gg, Gg, Gg, Gg^Fds, Rr, Rr, Gg, Gg^Fds, Gg^Fds, Wwf, Gg, Rr, Rr, Rr, Rr, Rr, Gg^Fds, Rr, Gg^Fds, Gg, Rr, Mm, Hh, Ww^Bsb\, Ww^Bsb\, Ww, Ww, Ww, Gg, Gs^Fp
Wo, Wo, Wo, Wo, Wo, Wo, Wo, Wo, Wo, Wo, Wo, Ww, Ww, Ds, Rr^Vhc, Rr, Rr, Rr, Gg^Fds, Rr, Rr, Gg, Hh, Wwf, Ww^Bw/, Rr^Vhc, Gg, Gg^Fds, Rr, Rr^Vhc, Rr, Rr, Gg, Gg, Mm, Ch, Ww^Bsb\, Ww, Ww, Ww^Bsb\, Ww^Bsb\, Hh, Gg, Gs^Fp
Wo, Wo, Wo, Wo, Wo, Wo, Wo, Wo, Wo, Wo, Wo, Wo, Ww, Ww^Bw/, Ds, Gg, Gg, Rr, Gg, Gg, Rr^Vhc, Hh, Ww, Ww, Ww, Ds, Rr^Vhc, Gg, Rr, Gg, Rr, Gg, Mm, Mm, Mm, Hh, Ww, Ww^Bsb\, Wwr, Ww, Ww, Ch, Re, Gg
Wo, Wo, Wo, Wo, Wo, Wo, Wo, Wo, Wo, Wo, Wo, Wo, Ww, Ww, Ww, Hh, Rr^Vhc, Rr, Rr^Vhc, Ds, Ww, Ww^Bw\, Ww, Ww, Ww, Ww^Bw/, Ww, Mm, Ch, Mm, Ch, Mm, Hh, Mm, Hh, Hh, Ww, Ww, Ww, Ww^Bsb\, Ww^Bsb\, Hh, Re, Re
Wo, Wo, Wo, Wo, Wo, Wo, Wo, Wo, Wo, Wo, Wo, Wo, Wo, Wo, Ww, Ww^Bw/, Ww, Ds, Ww^Bw|, Ww, Ww, Ww, Ww, Ww, Ww, Ww, Ww, Hh, Ww^Bsb|, Hh, Ww^Bsb|, Hh, Ww, Hh, Ww, Ww, Ww, Ww, Ww, Ww, Hh, Ch, Re, Gg
Wo, Wo, Wo, Wo, Wo, Wo, Wo, Wo, Wo, Wo, Wo, Wo, Wo, Wo, Wo, Ww, Ww, Ww, Ww, Ww, Ww, Wo, Wo, Wo, Wo, Ww, Ww, Ww, Wwr, Ww, Ww^Bsb|, Ww, Ww, Ww, Ww, Ww, Ww, Ww, Ds, Ds, Gg, Gg, Re, Gg
Wo, Wo, Wo, Wo, Wo, Wo, Wo, Wo, Wo, Wo, Wo, Wo, Wo, Wo, Wo, Wo, Ww, Ww, Ww, Ww, Ww, Wo, Wo, Wo, Wo, Wo, Ww, Ww, Wwr, Ww, Ww^Bsb|, Ww, Ww, Ww, Ww, Ww, Ww, Ww, Ds, Gg, Re, Re, Gg, Gg
Wo, Wo, Wo, Wo, Wo, Wo, Wo, Wo, Wo, Wo, Wo, Wo, Wo, Ww, Ww, Ww, Ww, Ww, Ds, Ww, Ww, Ww, Ww, Ww, Ww, Ww, Ww, Ww, Ww^Bsb|, Ww, Ww^Bsb|, Ww, Ww, Ww, Ds, Ww, Ds, Ds, Gg, Gg, Re, Gs^Fp, Gg, Gg
Wo, Wo, Wo, Wo, Wo, Wo, Wo, Wo, Wo, Wo, Wo, Wo, Wo, Ww, Ww, Ww, Ds, Ds, Gg, Ds, Gg, Ww, Ww, Ww, Ds, Ww, Ds, Hh, Ch, Hh, Ch, Hh, Gg, Ds, Gg, Gg, Gg, Gg, Gg^Vh, Re, Gs^Fp, Gs^Fp, Gs^Fp, Gs^Fp
Wo, Wo, Wo, Wo, Wo, Wo, Wo, Wo, Wo, Wo, Wo, Wo, Wo, Wo, Ww, Ww^Bw\, Gg^Vh, Gg, Gg, Gg, Gg, Gg, Gg, Ds, Gg, Ds, Gg, Gg^Vh, Gg, Re, Re, Gg, Gg^Vh, Gg, Re^Gvs, Re^Gvs, Re^Gvs, Gg, Gg, Gg, Gs^Fp, Gs^Fp, Gs^Fp, Gs^Fp
Wo, Wo, Wo, Wo, Wo, Wo, Wo, Wo, Wo, Wo, Wo, Wo, Wo, Ww, Ww, Ww, Gg, Gg, Gg, Gg, Gg, Gg, Gg, Gg^Vh, Gg, Gg, Re^Gvs, Re^Gvs, Re^Gvs, Gg, Re, Gg, Gg, Re^Gvs, Re^Gvs, Re^Gvs, Gg, Gg, Re^Gvs, Gg, Gg, Gs^Fp, Gg, Gg
Wo, Wo, Wo, Wo, Wo, Wo, Wo, Wo, Wo, Wo, Wo, Wo, Wo, Wo, Ww, Ww^Bw\, Gg^Vh, Gg, Gg, Gg, Re^Gvs, Re^Gvs, Re^Gvs, Gg, Gg, Re^Gvs, Re^Gvs, Re^Gvs, Gg, Gg, Re, Ce, Ce, Gg, Gg, Gg, Re^Gvs, Re^Gvs, Re^Gvs, Re^Gvs, Gg, Gg, Gg, Gg
Wo, Wo, Wo, Wo, Wo, Wo, Wo, Wo, Wo, Wo, Wo, Wo, Wo, Wo, Wo, Ww, Ww, Ds, Gg, Re^Gvs, Re^Gvs, Re^Gvs, Gg, Gg, Gs^Fp, Gg, Gg, Gg, Gg, Ce, Ce, Ke, Ce, Gg, Gg^Vh, Gg, Gg, Re^Gvs, Gg, Gg, Re^Gvs, Re^Gvs, Re^Gvs, Gg
Wo, Wo, Wo, Wo, Wo, Wo, Wo, Wo, Wo, Wo, Wo, Wo, Wo, Wo, Wo, Ww, Ww^Bw\, Hh, Gg, Gg, Gg, Gg, Gs^Fp, Gs^Fp, Gs^Fp, Gg, Re^Gvs, Re^Gvs, Re^Gvs, Gg, Gg, Ce, Gg, Gg, Gg, Gs^Fp, Gs^Fp, Gg, Re^Gvs, Re^Gvs, Re^Gvs, Re^Gvs, Re^Gvs, Re^Gvs
Wo, Wo, Wo, Wo, Wo, Wo, Wo, Wo, Wo, Wo, Wo, Wo, Wo, Wo, Ww, Ww, Ds, Gg^Vh, Gg, Gg, Gg, Gs^Fp, Gg, Gs^Fp, Gg, Gg, Gg^Vh, Re^Gvs, Re^Gvs, Re^Gvs, Gg, Re, Gs^Fp, Gs^Fp, Gs^Fp, Gs^Fp, Gs^Fp, Gg, Gg, Re^Gvs, Re^Gvs, Re^Gvs, Re^Gvs, Re^Gvs
Wo, Wo, Wo, Wo, Wo, Wo, Wo, Wo, Wo, Wo, Wo, Wo, Wo, Wo, Ww, Ww, Ds, Gg, Gg, Gg, Gg, Gs^Fp, Gg, Gs^Fp, Gg, Gg, Re, Gg, Gg, Gg, Re, Re, Gs^Fp, Gs^Fp, Gs^Fp, Gs^Fp, Gs^Fp, Gs^Fp, Gs^Fp, Gg, Gg, Re^Gvs, Gg, Gg
