Wo, Wo, Wo, Wo, Ww, Ww, Ds, Gg, Gs^Fp, Gs^Fp, Gg, Gs^Fp, Ss, Gs^Fp, Gs^Fp, Ww, Ww, Gs^Fp, Gs^Fp, Gs^Fp
Wo, Wo, Wo, Wo, Ww, Ww, Ds, Gg, Gs^Fp, Ss, Ww, Gg, Ww, Gs^Fp, Ww, Ww, Ww, Gs^Fp, Gs^Fp, Gs^Fp
Wo, Wo, Wo, Wo, Ww, Ww, Ww, Ds, Gg, Ww^Bsb\, Ch^Vhc, Ww^Bsb|, Ch^Vhc, Ww, Ww, Gs^Fp, Gs^Fp, Gs^Fp, Gs^Fp, Gs^Fp
Wo, Wo, Wo, Wo, Wo, Ww, Ww, Ds, Ds, Ww, Ch^Vhc, Kh, Ch^Vhc, Ww, Gg, Gs^Fp, Gs^Fp, Gs^Fp, Gg, Gg
Wo, Wo, Wo, Wo, Wo, Ww, Ww, Ww, Ww, Ww, Ww, Ch^Vhc, Ww, Ww^Bsb\, Gg, Gg, Gg, Gg, Re^Gvs, Gg
Wo, Wo, Wo, Wo, Wo, Wo, Wo, Ww, Ww, Ww, Ww, Ww, Ds, Gg, Gs^Fp, Gs^Fp, Gg, Re^Gvs, Re^Gvs, Re^Gvs
Wo, Wo, Wo, Wo, Wo, Wo, Wo, Wo, Ww, Ww, Ww, Ww, Ds, Gg, Gg, Gs^Fp, Gg, Gg, Gg, Gg
Wo, Wo, Wo, Wo, Wo, Wo, Wo, Wo, Wo, Ww, Ww, Ww, Ww, Ds, Ds, Gg, Re^Gvs, Re^Gvs, Re^Gvs, Gg
Wo, Wo, Wo, Wo, Wo, Wo, Wo, Wo, Wo, Wo, Ww, Ww, Ww, Ww, Ds, Gg, Gg, Re^Gvs, Gg, Ch
Wo, Wo, Wo, Wo, Wo, Wo, Wo, Wo, Wo, Wo, Wo, Ww, Ww, Ww, Ww, Ds, Gg, Gg, Re^Gvs, Gg
Wo, Wo, Wo, Wo, Wo, Wo, Wo, Wo, Wo, Wo, Wo, Wo, Ww, Ww, Ww, Ds, Gg, Re^Gvs, Re^Gvs, Re^Gvs
Wo, Wo, Wo, Wo, Wo, Wo, Wo, Wo, Wo, Wo, Wo, Wo, Ww, Ww, Ww, Ds, Ds, Gg, Gg, Gg
Wo, Wo, Wo, Wo, Wo, Wo, Wo, Wo, Wo, Wo, Wo, Wo, Wo, Ww, Ww, Ww, Ds, Gg, Gg, Gs^Fp
Wo, Wo, Wo, Wo, Wo, Wo, Wo, Wo, Wo, Wo, Wo, Wo, Wo, Ww, Ww, Ww, Ww, Ds, Gg, Gs^Fp
