Ha, Ha, Ha, Ha, Ha, Ha, Aa, Aa, Aa, Aa, Gg, Ww, Ww, Ww, Wo, Wo, Wo, Wo, Wo, Wo, Wo, Wo, Wo, Wo, Wo, Wo, Wo, Wo, Wo, Wo, Wo, Wo, Wo, Wo, Wo, Wo, Wo, Wo, Wo, Wo, Wo, Wo, Wo, Wo, Wo, Wo, Wo, Wo, Wo, Wo, Wo, Wo, Wo, Ww, Ww, Ww, Ww, Gs^Fp, Ww, Gs^Fp, Ww, Gs^Fp, Ww, Ww, Gg, Gs^Fp, Gs^Fp, Gs^Fp, Gg, Re, Re, Re
Ha, Ha, Ha, Ha, Ha, Ha, Aa, Aa, Aa, Aa, Gg, Ww, Ww, Ww, Wo, Wo, Wo, Wo, Wo, Wo, Wo, Wo, Wo, Wo, Wo, Wo, Wo, Wo, Wo, Wo, Wo, Wo, Wo, Wo, Wo, Wo, Wo, Wo, Wo, Wo, Wo, Wo, Wo, Wo, Wo, Wo, Wo, Wo, Wo, Wo, Wo, Wo, Wo, Ww, Ww, Ww, Ww, Gs^Fp, Ww, Gs^Fp, Ww, Gs^Fp, Ww, Ww, Gg, Gs^Fp, Gs^Fp, Gs^Fp, Gg, Re, Re, Re
Aa, Aa, Ha, Ha, Ha, Ha, Aa, Aa, Gg, Gg, Ww, Ww, Ww, Wo, Wo, Wo, Wo, Wo, Wo, Wo, Wo, Wo, Wo, Wo, Wo, Wo, Wo, Wo, Wo, Wo, Wo, Ww, Ww, Wo, Wo, Wo, Wo, Wo, Wo, Wo, Wo, Wo, Wo, Wo, Wo, Wo, Ww, Ww, Ww, Wo, Wo, Wo, Wo, Wo, Ww, Ww, Ww, Ww, Gg^Vh, Ww, Gg, Ww, Gg, Gg, Gg, Gg, Gg, Gg, Gg, Re, Gg, Gg
Aa, Aa, Aa, Aa, Aa, Aa, Gg, Gg, Ww, Ww, Wo, Wo, Wo, Wo, Wo, Wo, Wo, Wo, Wo, Wo, Wo, Wo, Wo, Wo, Wo, Wo, Wo, Wo, Wo, Ww, Gs^Fp, Gg, Gg, Wo, Wo, Wo, Wo, Wo, Wo, Wo, Wo, Wo, Wo, Wo, Wo, Wo, Wo, Ww, Gg, Ww, Ww, Wo, Wo, Wo, Wo, Ww, Wo, Ww, Ds, Gg, Gg, Gg, Gg, Gg, Gg, Gg, Gg, Gg, Re, Re, Gg, Gg
Gg, Gg, Gg, Gg, Aa, Gg, Gg, Gg, Ww, Wo, Ww, Ww, Wo, Wo, Ww, Ww, Ww, Wo, Wo, Wo, Wo, Wo, Wo, Wo, Wo, Wo, Wo, Wo, Wo, Ww, Gg, Hh, Ww, Ww, Wo, Wo, Wo, Wo, Wo, Wo, Wo, Wo, Wo, Wo, Wo, Wo, Wo, Ww, Gs^Fp, Gs^Fp, Gg^Vh, Ww, Wo, Wo, Wo, Wo, Wo, Ww, Ww, Gs^Fp, Gg, Gg, Gg, Gg, Gg, Gg, Gg, Gg, Re, Gg, Gg, Gg
Ww, Ww, Ww, Aa, Gg, Aa^Vha, Ww, Ww, Wo, Wo, Wo, Wo, Wo, Ww, Dd, Dd, Dd, Ww, Ww, Wo, Wo, Wo, Ww, Ww, Ww, Wo, Wo, Wo, Wo, Ww, Ww, Ww, Wo, Wo, Wo, Wo, Wo, Wo, Wo, Wo, Wo, Wo, Wo, Wo, Wo, Wo, Wo, Ww, Gg, Gs^Fp, Ww, Ww, Ww, Wo, Wo, Wo, Ww, Ww, Gg, Gg, Gg, Gg, Gg, Gg, Gg, Gg, Re, Re, Gg, Gg, Hh, Hh
Ww, Ww, Ww, Ww, Ww, Ww, Wo, Wo, Wo, Wo, Wo, Wo, Ww, Ww, Gs, Gs^Ft, Ww, Dd, Ww, Wo, Wo, Wo, Ww, Gs^Ft, Hh^Vhh, Ww, Wo, Wo, Wo, Ww, Wo, Wo, Ww, Wo, Wo, Wo, Ww, Ww, Ww, Wo, Wo, Wo, Wo, Wo, Wo, Wo, Ww, Ww, Ww, Gg, Ww, Ww, Ww, Wo, Wo, Ww, Ww, Ds, Gg, Gg, Ds, Gg, Gg, Gg, Re, Re, Gg, Gg, Gs^Fp, Gs^Fp, Hh, Hh
Ww, Ww, Ww, Wo, Wo, Wo, Wo, Wo, Wo, Wo, Wo, Wo, Ww, Dd, Gs^Ft, Hd, Gs, Dd, Ww, Wo, Wo, Ww, Hh, Ww, Gs, Ww, Wo, Wo, Wo, Ww, Wo, Ww, Ww, Ww, Wo, Ww, Ww, Gg^Vh, Gs^Fp, Ww, Wo, Wo, Wo, Wo, Wo, Wo, Ww, Gs^Fp, Gg, Ww, Ww, Gs^Fp, Ww, Ww, Wo, Ww, Ww, Ds, Ds, Ds, Ww, Ds, Ds, Re, Gg, Gg, Gg, Gs^Fp, Gs^Fp, Gs^Fp, Hh, Hh
Ww, Ww, Ww, Ww, Ww, Wo, Wo, Wo, Wo, Wo, Wo, Wo, Ww, Ww, Dd, Ww, Gs^Ft, Dd^Vda, Ww, Wo, Wo, Ww, Gs^Ft, Ww, Ww, Ww, Wo, Wo, Ww, Ww, Ww, Ww, Gg, Ww, Ww, Ww, Gs^Fp, Ds, Ww, Ww, Wo, Wo, Wo, Wo, Wo, Wo, Wo, Ww, Ww, Ww, Wo, Ww, Wo, Ww, Ww, Ww, Ww, Ww, Ww, Ww, Ww, Ww, Ww, Ds, Ds, Gg, Gg, Gs^Fp, Gs^Fp, Gs^Fp, Hh, Hh
Gg, Gg, Gg, Ds, Ds, Ww, Wo, Wo, Wo, Wo, Wo, Wo, Wo, Ww, Ww, Dd, Ww, Ww, Wo, Wo, Wo, Ww, Ww, Ww, Wo, Wo, Wo, Wo, Ww, Gg, Gs^Fp, Gg, Gs^Fp, Gg, Ww^Bw/, Ww^Bw/, Ww, Gg, Ww, Ww, Wo, Wo, Wo, Wo, Wo, Wo, Wo, Wo, Wo, Wo, Wo, Wo, Wo, Wo, Wo, Wo, Ww, Wo, Wo, Ww, Ww, Ww, Wo, Ww, Ds, Gg, Gg, Gg, Gg, Gg, Hd, Hd
Hh, Hh, Hh, Gg, Gg, Ww, Ww, Ww, Ww, Wo, Wo, Wo, Wo, Wo, Wo, Ww, Ww, Ww, Ww, Wo, Wo, Wo, Wo, Wo, Wo, Wo, Wo, Ww, Ww, Hh, Gg, Hh, Ww, Gg, Ww, Wo, Wo, Wo, Ww, Wo, Ww, Ww, Ww, Wo, Wo, Wo, Wo, Wo, Wo, Ww, Gg, Wo, Wo, Wo, Wo, Ww, Ww, Ww, Ww, Wo, Wo, Wo, Wo, Ww, Ww, Ds, Gg, Gg, Dd, Dd, Dd, Dd
Hh, Hh, Hh, Gg, Gg, Ds, Ds, Ds, Ds, Ww, Wo, Wo, Wo, Wo, Wo, Ww, Gs, Gs^Ft, Dd^Vda, Gs, Ww, Wo, Wo, Wo, Wo, Wo, Wo, Wo, Ww, Gg, Gs^Fp, Gg, Gg, Ww, Ds, Wo, Wo, Wo, Ww, Ww, Hh, Hh, Hh, Ww, Ww, Wo, Wo, Wo, Ww, Gg, Hh, Ww, Wo, Wo, Wo, Wo, Ww, Ww, Gg, Ww, Wo, Wo, Wo, Wo, Ww, Ds, Gg, Dd, Ss, Ss, Hd, Hd
Gg, Gg, Gg, Gg, Gg, Gs^Fp, Gg^Vh, Gg, Ww, Ww, Wo, Wo, Wo, Wo, Wo, Ww, Ww, Hh, Ww^Bw|, Ww, Ww, Wo, Wo, Wo, Wo, Wo, Wo, Wo, Wo, Ww, Ww, Gg, Ww^Bw\, Ww, Wo, Wo, Wo, Wo, Ww, Gg, Gs^Fp, Mm, Hh, Gg, Ww, Wo, Wo, Wo, Ww, Gg, Ww, Ww, Wo, Wo, Wo, Ww, Gg, Hh, Gg, Ww, Wo, Wo, Wo, Ww, Ds, Ds, Gg, Dd, Ss, Ss, Ss, Ss
Gg, Gg, Gg, Ww, Ww, Ww, Ww, Ww, Ww, Wo, Wo, Wo, Wo, Wo, Wo, Wo, Wo, Ww, Ww^Bw|, Wo, Wo, Wo, Wo, Wo, Wo, Wo, Wo, Wo, Wo, Wo, Wo, Ww, Ww, Ww, Ww, Ww, Wo, Wo, Ww, Gg, Gs^Fp, Hh, Gg^Vh, Gg, Ww, Wo, Wo, Wo, Wo, Wo, Wo, Wo, Wo, Wo, Ww, Ww, Ww, Gg, Ww, Ww, Wo, Wo, Ww, Ww, Ds, Gg, Gg, Dd, Dd, Hd, Ss, Ss
Gg, Gg, Gg, Gg, Gg, Gs^Fp, Gs^Fp, Ww, Ds, Ww, Wo, Wo, Wo, Wo, Wo, Wo, Ww, Wo, Ww^Bw|, Ww, Gs, Ww, Ww, Wo, Wo, Wo, Wo, Wo, Wo, Wo, Wo, Wo, Wo, Wo, Wo, Wo, Wo, Wo, Wo, Ww, Ww, Gg, Ww, Ww, Wo, Wo, Wo, Wo, Wo, Wo, Wo, Wo, Ww, Ww, Ww, Ww, Ww, Ww, Ww, Wo, Wo, Wo, Ww, Ds, Gg, Gg, Gg, Dd, Ss, Ss, Ss, Ss
Ww, Ww, Ww, Hh, Gg, Gs^Fp, Gg, Ds, Gg, Ww, Ww, Wo, Wo, Wo, Wo, Ww, Gs, Ww, Gs, Gs, Ww, Ww, Gs, Ww, Ww, Wo, Wo, Wo, Wo, Wo, Wo, Wo, Ww, Wo, Ww, Ww, Ww, Wo, Wo, Wo, Wo, Ww, Wo, Wo, Wo, Wo, Wo, Wo, Wo, Wo, Wo, Ww, Ww, Ww, Ds, Ds, Ds, Ww, Ww, Ww, Ww, Ww, Ds, Ds, Re, Gg, Gg, Dd, Dd, Ss, Hd, Hd
Hh, Hh, Ww, Gg, Gg, Gg, Ds, Gg, Ds, Ds, Ww, Wo, Wo, Wo, Ww, Ww, Gs, Gs, Hh, Gs^Ft, Gs, Gs^Ft, Ww, Ww, Wo, Wo, Wo, Wo, Wo, Wo, Wo, Wo, Ww, Ww, Gg, Gg, Ww, Wo, Wo, Wo, Wo, Wo, Wo, Wo, Wo, Wo, Wo, Wo, Wo, Wo, Ww, Ww, Ds, Ds, Gs^Fp, Gs^Fp, Gs^Fp, Gg, Gg, Ds, Gg, Ds, Gg, Gg, Gg, Re, Re, Gg, Re, Ss, Ss, Ss
Hh, Hh, Gg, Ww, Ww, Gg^Vh, Ww, Ds, Ww, Ww, Wo, Wo, Wo, Wo, Ww, Ww, Ww, Gs^Ft, Hh, Gs^Ft, Gs, Gs^Ft, Gs, Ww, Ww, Wo, Wo, Wo, Wo, Wo, Wo, Wo, Ww, Gg, Gg, Gs^Fp, Ww, Ww, Wo, Ww, Ww, Wo, Wo, Wo, Wo, Wo, Wo, Wo, Wo, Ww, Ww, Ds, Gs^Fp, Gs^Fp, Gs^Fp, Gs^Fp, Gs^Fp, Gs^Fp, Gs^Fp, Gs^Fp, Gs^Fp, Gg, Gg, Gg, Gg, Gg, Gg, Re, Dd, Re, Re, Re
Gg, Gg, Gg, Gs^Fp, Gs^Fp, Ww, Gg, Ww, Ww, Ww, Wo, Wo, Wo, Wo, Wo, Ww, Ww, Gs, Gs, Gs, Ww, Hh, Ww, Ww, Wo, Wo, Wo, Wo, Wo, Wo, Wo, Wo, Ww, Hh, Gg, Ww, Ww, Ww, Ww, Ww, Gg^Vh, Ww, Ww, Wo, Ww, Wo, Ww, Wo, Ww, Ww, Gg, Gg, Gs^Fp, Gs^Fp, Gs^Fp, Gs^Fp, Gs^Fp, Gs^Fp, Gs^Fp, Gs^Fp, Gs^Fp, Gg, Gs^Fp, Gg, Gg, Gg, Gg, Gg, Dd, Ss, Hd, Hd
Ds, Ds, Ds, Gs^Fp, Ww, Gg, Ds, Ds, Ww, Wo, Wo, Wo, Wo, Wo, Wo, Wo, Wo, Ww, Ww, Ww, Ww, Ww, Wo, Wo, Wo, Wo, Wo, Wo, Wo, Wo, Wo, Ww, Ww, Hh, Hh, Gs^Fp, Hh, Gg, Gg, Ww, Gs^Fp, Gg, Gg, Ww, Ww, Ww, Ww, Wo, Ww, Ww, Gg, Gs^Fp, Gs^Fp, Gs^Fp, Gs^Fp, Gs^Fp, Gs^Fp, Gs^Fp, Gs^Fp, Gs^Fp, Gs^Fp, Gs^Fp, Gs^Fp, Gs^Fp, Gs^Fp, Gg, Gg, Gg, Dd, Ss, Ss, Ss
Ww, Ww, Ww, Ww, Ww, Ww, Ww, Ww, Wo, Wo, Wo, Wo, Wo, Wo, Wo, Wo, Wo, Wo, Wo, Wo, Wo, Wo, Wo, Wo, Wo, Wo, Wo, Wo, Wo, Wo, Wo, Ww, Ww, Ww, Ww, Ww, Gg, Hh, Gs^Fp, Hh, Hh, Gg, Gg, Gs^Fp, Gg, Gg, Gs^Fp, Ww, Ww, Ww, Gs^Fp, Gs^Fp, Gs^Fp, Gs^Fp, Gs^Fp, Gs^Fp, Gs^Fp, Gs^Fp, Gs^Fp, Gs^Fp, Gs^Fp, Gs^Fp, Gs^Fp, Gs^Fp, Gs^Fp, Gs^Fp, Gs^Fp, Dd, Ss, Ss, Hd, Hd
Ww, Ww, Ww, Ww, Ww, Ww, Ww, Ww, Wo, Wo, Wo, Wo, Wo, Wo, Wo, Wo, Wo, Wo, Wo, Wo, Wo, Wo, Wo, Wo, Wo, Wo, Wo, Wo, Wo, Wo, Wo, Ww, Ww, Ww, Ww, Ww, Gg, Hh, Gs^Fp, Hh, Hh, Gg, Gg, Gs^Fp, Gg, Gg, Gs^Fp, Ww, Ww, Ww, Gs^Fp, Gs^Fp, Gs^Fp, Gs^Fp, Gs^Fp, Gs^Fp, Gs^Fp, Gs^Fp, Gs^Fp, Gs^Fp, Gs^Fp, Gs^Fp, Gs^Fp, Gs^Fp, Gs^Fp, Gs^Fp, Gs^Fp, Dd, Ss, Ss, Hd, Hd
