Gg^Fds, Gg^Fds, Rr, Gg^Fds, Gg^Fds, Gg, Rr, Rr, Gg^Fds, Rr, Gg^Fds, Gg, Rr, Gg, Gg^Fds, Rr, Rr, Gg, Rr, Gg^Fds, Rr, Rr, Gg^Fds
Gg^Fds, Gg^Fds, Rr^Vhc, Rr, Rr^Vhc, Gg, Rr, Rr, Gg, Rr, Rr, Rr, Gg^Fds, Gg, Gg, Gg^Fds, Rr, Gg^Fds, Rr, Rr^Vhc, Gg^Fds, Gg^Fds, Gg^Fds
Rr, Gg, Rr, Gg^Fds, Gg^Fds, Rr, Rr^Vhc, Gg, Gg^Fds, Ch, Gg^Fds, Rr^Vhc, Gg^Fds, Ch, Gg^Fds, Gg^Fds, Gg^Fds, Rr^Vhc, Rr, Rr, Rr^Vhc, Rr, Rr
Gg, Rr, Rr^Vhc, Rr, Rr^Vhc, Rr, Gg, Ch, Ch, Ch, Ch, Rr, Ch, Ch, Ch, Ch, Gg, Gg^Fds, Rr, Gg^Fds, Hh^Fds, Gg^Fds, Hh^Fds
Hh^Fds, Gg^Fds, Hh^Fds, Gg^Fds, Rr, Rr, Rr, Gg^Fds, Ch, Kh, Rr^Vhc, Rr, Rr^Vhc, Kh, Ch, Gg^Fds, Rr, Rr, Rr, Rr^Vhc, Gg^Fds, Hh^Fds, Gg^Fds
Hh^Fds, Hh^Fds, Rr, Rr^Vhc, Gg^Fds, Gg, Gg^Fds, Rr, Rr, Rr^Vhc, Gg^Fds, Ch, Gg^Fds, Rr^Vhc, Rr, Rr, Gg^Fds, Rr^Vhc, Gg, Rr, Rr^Vhc, Rr, Rr
Gg, Gg^Fds, Rr, Gg, Gg, Ch, Ch, Ch, Rr^Vhc, Ch, Ch, Ch, Ch, Ch, Rr^Vhc, Ch, Ch, Ch, Gg, Gg^Fds, Rr, Gg^Fds, Gg
Rr, Rr, Rr^Vhc, Gg^Fds, Gg, Gg^Fds, Ch, Kh, Rr^Vhc, Gg^Fds, Ch, Kh, Ch, Gg^Fds, Rr^Vhc, Kh, Ch, Gg^Fds, Gg, Rr^Vhc, Gg^Fds, Gg^Fds, Rr
Rr, Rr, Rr, Gg^Fds, Gg^Fds, Ch, Gg^Fds, Ch, Rr, Ch, Gg^Fds, Ch, Gg^Fds, Ch, Rr, Ch, Gg^Fds, Ch, Gg^Fds, Rr, Rr, Rr^Vhc, Gg
Gg, Gg^Fds, Rr, Gg^Fds, Gg^Fds, Rr, Rr, Rr, Ch, Rr^Vhc, Rr^Vhc, Ch, Rr^Vhc, Rr^Vhc, Ch, Rr, Rr, Gg, Rr^Vhc, Gg^Fds, Rr, Rr, Rr
Rr^Vhc, Rr^Vhc, Rr, Rr^Vhc, Rr, Rr, Gg, Gg^Fds, Ch, Kh, Ch, Rr, Ch, Kh, Ch, Gg^Fds, Gg, Rr, Rr, Rr, Hh^Fds, Gg^Fds, Hh^Fds
Gg^Fds, Rr, Rr^Vhc, Rr, Rr, Rr^Vhc, Gg^Fds, Ch, Gg^Fds, Ch, Gg^Fds, Rr, Gg^Fds, Ch, Gg^Fds, Ch, Gg^Fds, Gg^Fds, Rr, Gg^Fds, Hh^Fds, Hh^Fds, Hh^Fds
Rr, Rr, Rr, Gg^Fds, Hh^Fds, Rr, Rr, Gg, Gg, Ch, Rr, Rr, Gg, Ch, Gg, Gg^Fds, Rr, Rr, Rr, Gg^Fds, Rr^Vhc, Gg^Fds, Rr
Rr, Gg, Rr, Hh^Fds, Hh^Fds, Gg^Fds, Gg, Rr, Rr, Rr, Rr, Rr^Vhc, Rr, Rr, Rr, Rr, Rr^Vhc, Gg^Fds, Gg, Rr, Rr, Rr, Gg
