Wo, Wo, Wo, Wo, Wo, Wo, Wo, Wo, Wo, Wo, Wo, Wo, Wo, Wo, Wo, Wo, Wo, Wo, Wo, Wo, Wo, Wo
Wo, Wo, Wo, Wo, Wo, Wo, Wwr, Wwr, Wwr, Wo, Ww, Wo, Wo, Wo, Ww, Wo, Ww, Wwr, Wwr, Wo, Wo, Wo
Wo, Wo, Wo, Wo, Wwr, Wwr, Ww, Ww, Ww, Ww, Gs, Ww, Ww, Ww, Gs, Ww, Gs, Ww, Ww, Wwr, Wo, Wo
Wo, Wo, Wo, Wwr, Ww, Ww, Ss, Ss, Ss, Gs, Gs, Ss, Ss, Gs, Gs^Vht, Ss, Ss, Ss, Ww, Wwr, Wo, Wo
Wo, Wo, Wo, Wo, Ww, Ss, Gs, Ss, Rd, Gs^Vht, Hh, Rd, Rd, Rd, Rd, Gs, Ss, Ss, Ww, Wwr, Wo, Wo
Wo, Wo, Wo, Wo, Ww^Bw\r, Rd, Chr, Gs, Chr, Gs, Hh, Gs, Hh, Gs, Hh, Rd, Ww, Ww, Wo, Wo, Wo, Wo
Wo, Wo, Wo, Wo, Ww, Rd, Rd, Khr, Chr, Hh, Hh, Hh, Hh, Hh, Gs, Gs^Vht, Gs, Ww, Wo, Wo, Wo, Wo
Wo, Wo, Wwr, Wwr, Ww, Ww, Gs, Chr, Gs, Gs, Hh, Mm, Mm, Hh, Hh, Hh, Gs, Ww, Ww, Wo, Wo, Wo
Wo, Wo, Wwr, Ww, Ss, Ww, Rd, Rd, Hh, Hh, Mm, Mm, Mm, Mm, Hh, Hh, Hh, Rd, Ww, Wwr, Wwr, Wo
Wo, Wo, Wo, Ww, Gs, Gs, Rd, Gs^Vht, Gs, Hh, Hh, Hh, Hh, Mm, Hh, Gs, Gs, Gs, Ss, Ww, Wwr, Wo
Wo, Wo, Ww, Ww, Ss^Vhs, Rd, Ss, Rd, Rd, Hh, Gs, Gs, Hh, Hh, Gs, Hh, Rd, Ss, Ss, Ww, Wwr, Wo
Wo, Wwr, Ww, Ss, Rd, Gs, Ss, Ss, Rd, Gs, Rd, Rd, Rd, Gs, Gs, Hh, Rd, Gs, Ss, Ww, Wwr, Wo
Wo, Wwr, Ww, Ss, Rd, Ss, Gs, Ss, Ss, Rd, Ss, Ss, Gs, Rd, Gs, Rd, Gs, Gs^Vht, Gs, Ww, Wwr, Wo
Wo, Wwr, Wwr, Ww, Gs, Gs, Ss, Ss, Gs, Gs, Ss, Ss^Vhs, Ss, Rd, Ce, Ce, Rd, Gs, Ww, Ww, Wwr, Wo
Wo, Wo, Ww, Ww, Ss, Rd, Ss, Ss^Vhs, Rd, Ss, Gs, Ss, Gs, Rd, Rd, Ke, Ce, Rd, Ww^Bw\r, Ww, Wo, Wo
Wo, Wo, Ww, Ss, Gs, Rd, Rd, Ss, Gs, Rd, Gs, Ss, Rd, Ss, Gs, Ce, Gs, Gs, Ww, Wo, Wo, Wo
Wo, Wwr, Ww, Ss, Ss, Gs, Ss, Gs, Rd, Ss, Ss, Rd, Ss, Ss^Vhs, Ss, Gs, Ww, Ww, Wwr, Wo, Wo, Wo
Wo, Wwr, Wwr, Ww, Ss, Ss^Vhs, Ss, Ss, Gs, Gs, Ww, Ss, Ww, Ww, Ww, Gs, Ww, Ww, Wo, Wo, Wo, Wo
Wo, Wo, Wo, Ww, Ww, Ss, Ww, Ss, Ww, Ww, Wwr, Ww, Wwr, Wwr, Wwr, Ww, Wwr, Wwr, Wo, Wo, Wo, Wo
Wo, Wo, Wo, Wwr, Wwr, Ww, Wwr, Ww, Wwr, Wo, Wo, Wwr, Wo, Wo, Wo, Wwr, Wo, Wo, Wo, Wo, Wo, Wo
Wo, Wo, Wo, Wo, Wo, Wwr, Wo, Wo, Wo, Wo, Wo, Wo, Wo, Wo, Wo, Wo, Wo, Wo, Wo, Wo, Wo, Wo
Wo, Wo, Wo, Wo, Wo, Wo, Wo, Wo, Wo, Wo, Wo, Wo, Wo, Wo, Wo, Wo, Wo, Wo, Wo, Wo, Wo, Wo
