Wo, Wo, Wo, Wo, Wo, Wo, Wo, Wo, Wo, Wo, Wo, Wo, Wo, Wo, Wo, Wo, Ww, Ww, Ww, Ww, Ww, Wo, Wo, Wo, Wo, Wo, Wo, Wo, Wo, Wo
Wo, Wo, Wo, Wo, Wo, Wo, Wo, Wo, Wo, Wo, Wo, Wo, Wo, Wo, Wo, Wo, Ww, Ww, Ww, Ww, Ww, Wo, Wo, Wo, Wo, Wo, Wo, Wo, Wo, Wo
Wo, Wo, Wo, Wo, Wo, Wo, Wo, Wo, Ww, Wo, Ww, Ww, Ww, Ww, Ww, Ww, Ds, Ds, Gg, Ww, Ww, Ww, Ww, Wo, Wo, Wo, Wo, Wo, Wo, Wo
Wo, Wo, Wo, Wo, Wo, Wo, Ww, Ww, Ds, Ww, Ww, Ww, Ds, Ww, Ds, Ww, Gg, Gg, Hh, Gg, Gg, Ds, Ds, Ww, Ww, Wo, Wo, Wo, Wo, Wo
Wo, Wo, Wo, Wo, Ww, Ww, Ds, Ds, Gg, Ds, Gg, Gg, Gg, Gg, Gg, Gg^Vh, Gg, Hh, Mm, Hh, Hh, Gg, Gg, Ds, Ww, Ww, Ww, Wo, Wo, Wo
Wo, Wo, Wo, Ww, Ww, Ww, Gg, Gg, Hh, Gg, Gg, Gg, Gg, Hh, Gg, Hh, Hh, Hh, Mm, Mm, Hh, Gg^Vh, Hh, Gg, Gg, Ww, Ww, Wo, Wo, Wo
Wo, Wo, Wo, Ww, Ww, Gg, Gg, Hh, Hh, Hh, Mm, Gg, Hh, Gg, Gg, Mm, Mm, Hh, Mm, Hh, Mm, Hh, Mm, Hh, Gg, Ww, Ww, Wo, Wo, Wo
Wo, Wo, Wo, Ww, Ww, Gg, Gg, Hh, Hh, Mm, Hh, Mm, Mm, Mm, Mm, Mm, Mm, Mm, Mm, Mm, Mm, Mm, Hh, Hh, Gg, Ds, Ww, Wo, Wo, Wo
Wo, Wo, Wo, Ww, Ww, Ww, Ww, Gg, Gg, Hh, Hh, Hh, Mm, Mm, Co, Co, Co, Mm, Mm, Mm, Mm, Mm, Hh, Gg^Vh, Ds, Ds, Ww, Wo, Wo, Wo
Wo, Wo, Wo, Wo, Wo, Ww, Ww, Gg, Gg, Gg^Vh, Hh, Mm, Mm, Mm, Co, Ko, Co, Hh, Hh, Mm, Mm, Mm, Hh, Gg, Ds, Ww, Ww, Wo, Wo, Wo
Wo, Wo, Wo, Wo, Ww, Ww, Ds, Gg, Gg, Gg, Hh, Mm, Mm, Mm, Mm, Co, Ww, Ww, Hh, Mm, Mm, Mm, Hh, Gg, Gg, Ds, Ww, Wo, Wo, Wo
Wo, Wo, Ww, Ww, Ds, Ds, Gg, Gg, Gg, Gg, Hh, Mm, Mm, Mm, Mm, Mm, Hh, Ww, Hh, Mm, Hh, Hh, Mm, Gg, Gg, Ds, Ww, Wo, Wo, Wo
Wo, Wo, Ww, Ds, Ds, Ds, Gg, Gs^Fp, Gs^Fp, Gs^Fp, Gs^Fp, Hh, Hh, Mm, Mm, Mm, Hh, Ww, Hh, Mm, Hh, Hh, Hh, Hh, Gg, Ds, Ww, Wo, Wo, Wo
Wo, Wo, Ww, Ds, Ds, Gg, Gg, Gs^Fp, Gs^Fp, Gs^Fp, Mm, Hh, Gg^Vh, Hh, Hh, Mm, Hh, Ww, Gg, Hh, Gg^Vh, Gg, Gg, Hh, Hh, Ds, Ww, Wo, Wo, Wo
Wo, Wo, Ww, Ds, Ds, Gg, Gs^Fp, Gs^Fp, Gs^Fp, Hh, Hh, Gs^Fp, Gs^Fp, Gg, Gg, Hh, Gg, Ww, Ww, Gg, Gg, Gg, Gg, Hh, Hh, Ds, Ds, Ww, Wo, Wo
Wo, Wo, Ww, Ds, Ds, Ds, Gs^Fp, Gg^Vh, Gs^Fp, Gs^Fp, Mm, Hh, Gs^Fp, Gg, Gs^Fp, Mm, Hh, Ww, Ww, Gg, Gg, Gg, Gg, Hh, Gg, Gg^Vh, Ds, Ww, Wo, Wo
Wo, Wo, Ww, Ds, Ds, Ds, Gg, Gs^Fp, Gs^Fp, Hh, Hh, Hh, Gs^Fp, Gs^Fp, Gs^Fp, Hh, Mm, Gg, Ww, Ww, Gg, Gg, Gg, Gg, Gg, Gg, Ds, Ww, Wo, Wo
Wo, Wo, Ww, Ww, Ds, Ds, Ds, Gs^Fp, Gs^Fp, Gs^Fp, Gs^Fp, Mm, Hh, Gs^Fp, Gs^Fp, Gs^Fp, Hh, Gg, Gg, Ww, Wwf, Gg, Ce, Ce, Ce, Gg, Ww, Ww, Wo, Wo
Wo, Wo, Ww, Ds, Ds, Ds, Ds, Ds, Gs^Fp, Gg, Gs^Fp, Hh, Gs^Fp, Gs^Fp, Gs^Fp, Gg, Gs^Fp, Gs^Fp, Gg, Ww, Ww, Gg, Ce, Ke, Ce, Ds, Ww, Wo, Wo, Wo
Wo, Wo, Ww, Ds, Ds, Ds, Ds, Ds, Gg, Gg, Gs^Fp, Gs^Fp, Gs^Fp, Gs^Fp, Gs^Fp, Gg^Vh, Gs^Fp, Gg, Gg, Wwf, Wwf, Gg, Gg, Ce, Gg, Ds, Ww^Bw/, Wo, Wo, Wo
Wo, Wo, Wo, Ww, Ww, Ww, Ds, Ds, Ds, Ds, Gg^Vh, Gs^Fp, Gs^Fp, Gs^Fp, Gs^Fp, Gs^Fp, Gg, Gg, Gg, Gg, Wwf, Wwf, Gg, Gg, Gg, Gg^Vh, Ds, Ww, Wo, Wo
Wo, Wo, Wo, Wo, Wo, Ww, Ww, Ds, Ds, Ds, Gg, Gs^Fp, Gs^Fp, Gs^Fp, Gs^Fp, Gs^Fp, Gg, Gs^Fp, Gg, Gg, Gg, Wwf, Wwf, Gg^Vh, Gg, Gg, Ds, Ww, Wo, Wo
Wo, Wo, Wo, Wo, Wo, Wo, Wo, Ww, Ww, Ds, Ds, Gs^Fp, Gs^Fp, Gs^Fp, Gs^Fp, Gg, Gs^Fp, Gs^Fp, Gg, Hh, Gg, Wwf, Wwf, Wwf, Wwf, Wwf, Ww, Ww, Wo, Wo
Wo, Wo, Wo, Wo, Wo, Wo, Wo, Wo, Ww, Ds, Ds, Ds, Ds, Ds, Gg, Gg, Gg, Hh, Mm, Mm, Hh, Gg^Vh, Gg, Wwf, Wwf, Gg^Vh, Ww, Wo, Wo, Wo
Wo, Wo, Wo, Wo, Wo, Wo, Wo, Wo, Wo, Ww, Ww, Ds, Ds, Ds, Gg, Gg, Gg, Hh, Hh, Mm, Hh, Gg, Gg, Gg^Vh, Ww, Ds, Wo, Wo, Wo, Wo
Wo, Wo, Wo, Wo, Wo, Wo, Wo, Wo, Wo, Wo, Wo, Ww, Ww, Ds, Ds, Gg, Ds, Gg, Gg, Gg, Gg, Gg, Ds, Ds, Ww, Ww, Wo, Wo, Wo, Wo
Wo, Wo, Wo, Wo, Wo, Wo, Wo, Wo, Wo, Wo, Wo, Wo, Wo, Ww, Ww, Ds, Ds, Ds, Ds, Ds, Ds, Ds, Ww, Ww, Wo, Wo, Wo, Wo, Wo, Wo
Wo, Wo, Wo, Wo, Wo, Wo, Wo, Wo, Wo, Wo, Wo, Wo, Wo, Wo, Wo, Ww, Ww, Ds, Ww, Ww, Ww, Ww, Wo, Wo, Wo, Wo, Wo, Wo, Wo, Wo
Wo, Wo, Wo, Wo, Wo, Wo, Wo, Wo, Wo, Wo, Wo, Wo, Wo, Wo, Wo, Wo, Wo, Ww, Wo, Wo, Wo, Wo, Wo, Wo, Wo, Wo, Wo, Wo, Wo, Wo
Wo, Wo, Wo, Wo, Wo, Wo, Wo, Wo, Wo, Wo, Wo, Wo, Wo, Wo, Wo, Wo, Wo, Wo, Wo, Wo, Wo, Wo, Wo, Wo, Wo, Wo, Wo, Wo, Wo, Wo
