Wo, Wo, Wo, Wo, Wo, Wo, Wo, Wo, Wo, Wo, Wo, Wo, Wo, Wo, Wo, Wo, Ww, Ww, Ds, Ww, Ww, Wo, Wo, Wo, Wo, Wo, Wo, Wo, Wo, Wo
Wo, Wo, Wo, Wo, Wo, Wo, Wo, Wo, Wo, Wo, Wo, Wo, Wo, Wo, Wo, Ww, Ds, Ds, Ds, Ds, Ds, Ww, Ww, Wo, Wo, Wo, Wo, Wo, Wo, Wo
Wo, Wo, Wo, Wo, Ww, Ww, Ww, Ww, Ww, Wo, Ww, Ww, Ww, Ww, Ww, Ww, Ds, Ds, Ds, Gs, Gs, Ds, Ww, Wo, Ww, Ww, Ww, Wo, Wo, Wo
Wo, Wo, Wo, Wo, Ww, Ww, Ds, Ww, Ds, Ww, Ds, Ww, Ds, Ds, Ds, Ds, Ds, Gs, Hh, Gd^Vo, Gs, Ds, Ds, Ww, Ds, Ww, Ww, Ww, Wo, Wo
Wo, Wo, Wo, Ww, Ww, Ds, Ds, Ds, Gs, Ds, Gs, Ds, Gs, Gs, Gs, Ds, Gs, Hh, Mm, Hh, Hh, Ds, Ds, Ds, Ds, Ds, Ds, Ww, Ww, Wo
Wo, Wo, Ww, Ww, Ds, Ds, Ds, Gs, Hh, Gs, Hh, Gd^Vo, Gll^Fp, Hh, Hh, Hh, Hh^Fp, Hh^Fp, Mm, Mm, Hh^Fp, Gs, Hh, Gs, Hh, Gs, Ds, Ww, Ww, Wo
Wo, Wo, Ww, Ww, Ds, Ds, Gs, Gs, Hh, Hh, Mm, Hh^Fp, Hh^Fp, Hh^Fp, Mm, Mm, Mm, Hh^Fp, Mm, Hh^Fp, Hh^Fp, Hh, Mm, Hh, Gs, Gs, Ds, Ww, Ww, Wo
Wo, Wo, Wo, Ww, Ww, Ds, Ds, Hh, Hh, Mm, Hh^Fp, Mm, Mm, Mm, Hh^Fp, Mm, Hh^Fp, Mm, Mm, Mm, Mm, Mm, Hh, Hh, Ds, Ds, Ww, Ww, Wo, Wo
Wo, Wo, Wo, Ww, Ww, Ds, Ds, Gs, Hh, Hh, Hh, Mm, Mm, Mm, Hh, Hh, Wwf, Hh^Vo, Hh^Fp, Mm, Mm, Hh^Fp, Gll^Fp, Gs, Ds, Ds, Ww, Ww, Wo, Wo
Wo, Wo, Wo, Wo, Ww, Ww, Ds, Ds, Gs, Gs, Hh, Mm, Co, Hh^Fp, Hh, Wwf, Wwf, Hh, Mm, Mm, Mm, Hh, Gll^Fp, Ds, Ds, Ww, Ww, Ww, Wo, Wo
Wo, Wo, Wo, Wo, Ww, Ww, Ds, Ds, Gd^Vo, Gs, Hh, Mm, Ko, Co, Hh^Fp, Wwf, Wwf, Wwf, Hh, Mm, Hh^Fp, Hh^Fp, Hh^Vo, Gs, Ds, Ww, Ww, Wo, Wo, Wo
Wo, Wo, Ww, Ww, Ds, Ds, Gs, Gs, Gs, Hh, Hh, Co, Mm, Co, Mm, Hh, Hh, Wwf, Hh, Mm, Mm, Hh^Fp, Hh^Fp, Gll^Fp, Gs, Ds, Ww, Wo, Wo, Wo
Wo, Wo, Ww, Ds, Ds, Ds, Gs, Gll^Fp, Gll^Fp, Hh, Gs, Hh, Hh, Mm, Mm, Mm, Mm, Wwf, Hh, Mm, Hh, Mm, Hh^Fp, Hh^Fp, Gll^Fp, Ds, Ww, Wo, Wo, Wo
Wo, Ww, Ds, Ds, Ds, Gs, Gll^Fp, Gll^Fp, Gll^Fp, Gll^Fp, Gs, Hh, Hh^Fp, Hh, Hh, Mm, Hh, Ww, Gs, Hh, Gs, Hh^Fp, Hh^Fp, Hh^Fp, Gll^Fp, Ds, Ww, Ww, Wo, Wo
Wo, Ww, Ww, Ds, Ds, Gs, Gs, Gll^Fp, Gll^Fp, Gs, Gs, Gll^Fp, Gll^Fp, Gll^Fp, Gs, Hh, Gs, Ww, Ww, Gs, Gll^Fp, Gll^Fp, Hh^Fp, Gll^Fp, Gs, Ds, Ds, Ww, Wo, Wo
Wo, Wo, Ww, Ds, Ds, Ds, Gs, Gd^Vo, Hh, Hh, Hh, Gll^Fp, Gll^Fp, Gll^Fp, Hh, Hh, Hh^Vo, Wwf, Ww, Gs, Gs, Gll^Fp, Gll^Fp, Gll^Fp, Gll^Fp, Gs, Ds, Ww, Wo, Wo
Wo, Wo, Ww, Ww, Ds, Ds, Gs, Gll^Fp, Gll^Fp, Mm, Hh, Gs, Gs, Gll^Fp, Gs, Mm, Hh, Gs, Ww, Wwf, Gs, Gll^Fp, Gs, Gs, Gs, Gs, Ds, Ww, Wo, Wo
Wo, Ww, Ww, Ww, Ds, Ds, Gs, Gll^Fp, Gll^Fp, Hh^Fp, Hh, Mm, Hh, Gs, Gll^Fp, Hh, Mm, Gs, Gs, Ww, Wwf, Gs, Chr, Gs, Gs, Chr, Ww, Ww, Wo, Wo
Wo, Ww, Ww, Ds, Ds, Gs, Gs, Gs, Gll^Fp, Gs, Gll^Fp, Hh, Gs, Hh, Gll^Fp, Hh, Gll^Fp, Hh, Gs, Ww, Ww, Gs, Chr, Gs, Chr, Ds, Ww, Wo, Wo, Wo
Wo, Ww, Ww, Ds, Ds, Ds, Gs, Gll^Fp, Gs, Gs, Gll^Fp, Gll^Fp, Gll^Fp, Gll^Fp, Gll^Fp, Gll^Fp, Gll^Fp, Gs, Gs, Wwf, Wwf, Chw, Chr, Khr, Gs, Ds, Ww^Bw/r, Wo, Wo, Wo
Wo, Wo, Ww, Ww, Ds, Ds, Ds, Gs, Ds, Gs, Gs, Gs, Gll^Fp, Gs, Gs, Gs, Gs, Gs, Gs, Gs, Wwf, Wwf, Gs, Gs, Gs, Gd^Vhr, Ds, Ww, Wo, Wo
Wo, Wo, Wo, Ww, Ww, Ds, Ds, Ds, Ds, Ds, Gs, Gll^Fp, Gll^Fp, Gll^Fp, Gll^Fp, Gll^Fp, Hh, Gll^Fp, Gs, Gs, Gs, Chw, Wwf, Gd^Vhr, Gs, Gs, Ds, Ww, Wo, Wo
Wo, Wo, Wo, Ww, Ww, Ds, Ww, Ds, Ww, Ds, Ds, Gs, Gll^Fp, Gll^Fp, Gll^Fp, Gll^Fp, Hh^Fp, Hh, Hh^Fp, Hh, Gs, Wwf, Wwf, Wwf, Wwf, Wwf, Ww, Ww, Wo, Wo
Wo, Wo, Wo, Ww, Ww, Ww, Ww, Ww, Ds, Ds, Ds, Gs, Gs, Gd^Vo, Gll^Fp, Gll^Fp, Gs^Fp, Mm, Mm, Mm, Hh, Gs, Chr, Wwf, Wwf, Gd^Vhr, Ww, Ww, Wo, Wo
Wo, Wo, Wo, Wo, Wo, Wo, Wo, Ww, Ww, Ds, Ds, Gs, Ds, Gs, Gs, Gll^Fp, Gs, Hh^Fp, Hh, Hh^Fp, Hh, Gs, Gs, Gs, Ww, Ds, Ww, Ww, Wo, Wo
Wo, Wo, Wo, Wo, Wo, Wo, Wo, Ww, Ww, Ds, Ds, Ds, Ds, Ds, Ds, Gs, Ds, Gs, Gs, Gs, Gs, Gs, Ds, Ds, Ww, Ww, Ww, Wo, Wo, Wo
Wo, Wo, Wo, Wo, Wo, Wo, Wo, Wo, Ww, Ww, Ww, Ds, Ww, Ds, Ww, Ds, Ds, Ds, Ds, Ds, Ds, Ds, Ww, Ww, Ww, Ww, Wo, Wo, Wo, Wo
Wo, Wo, Wo, Wo, Wo, Wo, Wo, Wo, Wo, Ww, Ww, Ww, Ww, Ww, Ww, Ww, Ww, Ds, Ww, Ww, Ww, Ww, Ww, Wo, Wo, Wo, Wo, Wo, Wo, Wo
Wo, Wo, Wo, Wo, Wo, Wo, Wo, Wo, Wo, Wo, Wo, Wo, Wo, Wo, Wo, Wo, Wo, Ww, Wo, Ww, Wo, Ww, Wo, Wo, Wo, Wo, Wo, Wo, Wo, Wo
Wo, Wo, Wo, Wo, Wo, Wo, Wo, Wo, Wo, Wo, Wo, Wo, Wo, Wo, Wo, Wo, Wo, Wo, Wo, Wo, Wo, Wo, Wo, Wo, Wo, Wo, Wo, Wo, Wo, Wo
