Wo, Wo, Wo, Wo, Wo, Wo, Wo, Wo, Wo, Wo, Wo, Wo, Wo, Wo, Wo, Wo, Wo, Wo, Wo, Wo, Wo, Wo, Wo
Wo, Wo, Wo, Wo, Wo, Wo, Wo, Wo, Ww, Wo, Ww, Ww, Ww, Wo, Wo, Wo, Ww, Wo, Ww, Wo, Wo, Wo, Wo
Wo, Wo, Wo, Wo, Wo, Wo, Ww, Ww, Ds, Ww, Ds, Ds, Ww, Ww, Ww, Ww, Ds, Ww, Ds, Ww, Ww, Wo, Wo
Wo, Wo, Wo, Wo, Wo, Wo, Ww, Ds, Ke, Ds, Gg, Ds, Ds, Ds, Ds, Ds, Gs^Fp, Ds, Ds, Ds, Ww, Wo, Wo
Wo, Wo, Wo, Wo, Ww, Ww, Gs^Fp, Ce, Ce, Ce, Gg^Efm, Gs^Fp, Gs^Fp, Gs^Fp, Gs^Fp, Gs^Fp, Gs^Fp, Gs^Fp, Ds, Ww, Ww, Wo, Wo
Wo, Wo, Wo, Wo, Ww, Ds, Ds, Gs^Fp, Gg^Efm, Gg^Efm, Gs^Vo, Gg, Gg, Gs^Fp, Gs^Fp, Gg, Gs^Vo, Gs^Fp, Gg, Ds, Ww, Wo, Wo
Wo, Wo, Wo, Wo, Wo, Ww, Ds, Gs^Fp, Gg, Hh, Hh, Hh, Gg^Efm, Gg^Efm, Gg^Efm, Gg, Hh, Gs^Fp, Gg, Ds, Ds, Ww, Wo
Wo, Wo, Wo, Wo, Wo, Ww, Ww, Gs^Fp, Hh, Hh, Gs^Fp, Hh, Gs^Fp, Gg^Efm, Hh, Hh, Gs^Fp, Gs^Fp, Gs^Fp, Gs^Vo, Ds, Ww, Wo
Wo, Wo, Wo, Wo, Wo, Ww, Ds, Ds, Gs^Fp, Gs^Fp, Gg, Gs^Fp, Gs^Fp, Gg^Efm, Gg, Hh, Hh, Gs^Fp, Gs^Fp, Ds, Ww, Ww, Wo
Wo, Wo, Wo, Wo, Wo, Ww, Ww, Ds, Gg, Gs^Vo, Gs^Fp, Gs^Fp, Gs^Fp, Gs^Fp, Gg, Hh, Hh, Gs^Fp, Ds, Ds, Ds, Ww, Wo
Wo, Wo, Wo, Wo, Ww, Ww, Ds, Ww, Wwf, Ds, Gg, Ds, Ds, Gg, Ds, Gg, Wwf, Ds, Ww, Ww, Ww, Ww, Wo
Wo, Wo, Wo, Wo, Ww, Ww, Ww, Wwf, Ds, Wwf, Ds, Wwf, Wwf, Wwf, Ds, Wwf, Wwf, Wwf, Ds, Ww, Ww, Wo, Wo
Wo, Wo, Wo, Ww, Ds, Ds, Hh, Gg, Hh, Gg, Hh, Ds, Gs^Fp, Ds, Gs^Vo, Ds, Hh, Gg, Gs^Fp, Ds, Ww, Wo, Wo
Wo, Wo, Ww, Ww, Ds, Gg, Gs^Fp, Hh, Gs^Fp, Hh, Hh, Gs^Fp, Gs^Fp, Gg, Hh, Hh, Hh, Gs^Fp, Gs^Fp, Ds, Ww, Wo, Wo
Wo, Wo, Wo, Ww, Ww, Ce, Gs^Fp, Gs^Fp, Gs^Fp, Gs^Fp, Gg, Gs^Fp, Gg^Efm, Gg^Efm, Gg^Efm, Gg, Gs^Fp, Gs^Fp, Gg, Ds, Ds, Ww, Wo
Wo, Wo, Wo, Ww, Ds, Ds, Gg^Efm, Ce, Gg^Efm, Gs^Vo, Gg, Gg, Gs^Fp, Gg^Efm, Gg^Efm, Gs^Vo, Gs^Fp, Gs^Fp, Ds, Ds, Ds, Ww, Wo
Wo, Wo, Ww, Ww, Ww^Bw/, Gg, Gg^Efm, Gg^Efm, Ce, Gg, Gs^Fp, Gs^Fp, Gs^Fp, Gs^Fp, Gg, Hh, Gs^Fp, Gs^Fp, Ds, Ww, Ww, Ww, Wo
Wo, Wo, Ww^Bw/, Ww^Bw/, Ww, Ds, Ce, Ket, Ce, Gg, Gs^Fp, Gg, Gs^Vo, Gg, Hh, Hh, Gg, Gs^Fp, Ds, Ww, Ww, Wo, Wo
Ww^Bw/, Ww^Bw/, Wo, Ww, Ww, Ww, Ds, Gg, Ds, Ds, Ds, Gg, Ds, Hh, Gg, Hh, Ds, Ds, Ww, Ds, Ww, Wo, Wo
Ww, Wo, Wo, Wo, Ww, Ds, Ww, Ds, Ww, Ww, Ww, Ww, Ds, Ds, Ww, Ds, Ww, Ds, Ww, Ww, Wo, Wo, Wo
Wo, Wo, Wo, Wo, Wo, Ww, Wo, Ww, Wo, Wo, Wo, Ww, Ww, Ww, Wo, Ww, Ww, Ww, Wo, Wo, Wo, Wo, Wo
Wo, Wo, Wo, Wo, Wo, Wo, Wo, Wo, Wo, Wo, Wo, Wo, Wo, Wo, Wo, Wo, Wo, Wo, Wo, Wo, Wo, Wo, Wo
