Wo, Wo, Wo, Wo, Wo, Wo, Wo, Wo, Wo, Wo, Wo, Wo, Wo, Wo, Wo, Wo, Wo, Wo, Wo, Wo, Wo, Wo, Wo, Wo, Wo, Wo, Wo, Wo, Wo, Wo, Wo, Wo, Wo, Wo, Wo, Wo, Wo, Wo, Wo, Wo, Wo, Wo
Wo, Wo, Wo, Wo, Wo, Wo, Wo, Wo, Wo, Wo, Wo, Wo, Wo, Wo, Wo, Wo, Wo, Wo, Wo, Wo, Wo, Wo, Ww, Wo, Ww, Wo, Ww, Wo, Ww, Ww, Ww, Ww, Ww, Wo, Wo, Wo, Wo, Wo, Wo, Wo, Ww, Ww
Wo, Wo, Wo, Wo, Wo, Wo, Wo, Wo, Wo, Wo, Wo, Wo, Wo, Wo, Wo, Wo, Wo, Wo, Wo, Wo, Ww, Ww, Ds, Ww, Ds, Ww, Ds, Ww, Ds, Ds, Ds, Ds, Ds, Ww, Ww, Wo, Ww, Wo, Ww, Ww, Ww^Bw/, Ww^Bw/
Wo, Wo, Wo, Wo, Wo, Wo, Wo, Wo, Wo, Wo, Wo, Wo, Ww, Wo, Wo, Wo, Wo, Ww, Ww, Ww, Ds, Ds, Hh, Ds, Hh, Ds, Gg, Ds, Gg, Gs^Fp, Gg, Gs^Fp, Gs^Fp, Ds, Ds, Ww, Ww, Ww, Ww^Bw/, Ww^Bw/, Ww, Ww
Wo, Wo, Wo, Wo, Wo, Wo, Wo, Wo, Wo, Wo, Ww, Ww, Ww, Ww, Ww, Ww, Ww, Ww, Ds, Ds, Gs^Fp, Hh, Gs^Fp, Hh, Gg^Vh, Gg, Gs^Fp, Gs^Fp, Hh, Gg, Gg, Gg, Ce, Gs^Fp, Gs^Fp, Ds, Gg, Ww^Bw/, Ww, Ww, Wo, Wo
Wo, Wo, Wo, Wo, Wo, Wo, Wo, Ww, Ww, Ww, Ds, Ds, Ds, Ds, Ds, Ds, Ds, Ds, Gs^Fp, Gs^Fp, Gs^Fp, Gs^Fp, Gs^Fp, Gs^Fp, Gg, Gg, Gs^Fp, Gs^Fp, Gs^Fp, Hh, Gg, Ce, Ke, Ce, Gs^Fp, Gg^Vh, Ds, Ww, Wo, Wo, Wo, Wo
Wo, Wo, Wo, Wo, Wo, Wo, Wo, Ww, Ds, Ds, Gs^Fp, Gs^Fp, Gs^Fp, Gs^Fp, Gs^Fp, Hh, Gg, Gg, Gs^Fp, Gs^Fp, Gs^Fp, Gs^Fp, Gg, Gs^Fp, Gg, Gg, Gg, Gs^Fp, Hh, Hh, Gg, Ce, Ce, Ce, Gs^Fp, Ds, Ww, Ww, Wo, Wo, Wo, Wo
Wo, Wo, Wo, Wo, Wo, Wo, Wo, Ww, Ds, Gg^Vh, Hh, Hh, Hh, Gs^Fp, Hh, Hh, Gg, Gg, Gg, Gg, Gg, Gg, Gs^Fp, Gg, Gg, Gg, Gg, Gg, Gs^Fp, Hh, Gg^Vh, Gg, Ds, Gs^Fp, Ds, Ds, Ww, Ww, Wo, Wo, Wo, Wo
Wo, Wo, Wo, Wo, Wo, Wo, Wo, Ww, Ww, Ds, Gs^Fp, Hh, Gg, Hh, Gg, Gg, Gg, Gg, Gg, Gg, Gg^Vh, Hh, Hh, Hh, Ds, Gg, Ds, Ds, Ds, Ds, Ds, Ds, Ww, Ds, Ww, Ww, Ww, Ww, Ww, Wo, Wo, Wo
Wo, Wo, Wo, Wo, Wo, Wo, Wo, Wo, Ww, Ds, Gs^Fp, Gs^Fp, Gg, Gg, Gs^Fp, Gs^Fp, Hh, Gs^Fp, Hh, Gs^Fp, Gs^Fp, Hh, Ds, Ds, Ww, Ds, Ww, Ww, Ww, Ww, Ww, Ww, Wo, Ww, Wo, Ww, Ds, Ds, Ds, Ww, Wo, Wo
Wo, Wo, Wo, Wo, Wo, Wo, Wo, Ww, Ww, Ds, Gs^Fp, Gg^Vh, Gg, Gg, Gg, Gs^Fp, Hh, Hh, Gs^Fp, Gs^Fp, Ds, Ds, Ww, Ww, Ww, Ww, Wo, Ww, Ww, Ww, Ww, Wo, Wo, Wo, Wo, Ww, Ds, Gs^Fp, Ds, Ww, Wo, Wo
Wo, Wo, Wo, Wo, Wo, Wo, Wo, Ww, Ww, Ds, Gg, Gs^Fp, Gg, Gg, Gs^Fp, Hh, Gs^Fp, Gs^Fp, Ds, Gs^Fp, Ds, Ww, Wo, Ww, Wo, Wo, Wo, Wo, Ww, Ww, Ww, Wo, Wo, Wo, Ww, Ww, Ds, Gg^Vh, Ds, Ww, Wo, Wo
Wo, Wo, Wo, Wo, Wo, Wo, Wo, Wo, Ww, Ds, Gg, Gg, Gs^Fp, Gg, Hh, Hh, Ds, Ds, Ww, Ds, Ww, Ww, Wo, Wo, Wo, Wo, Ww, Ww, Ds, Ds, Ds, Ww, Ww, Ww, Ww, Ds, Gg, Gg, Ds, Ww, Ww, Wo
Wo, Wo, Wo, Wo, Wo, Wo, Wo, Wo, Ww, Ds, Hh, Gs^Fp, Gs^Fp, Gs^Fp, Gs^Fp, Gg, Ds, Ww, Ww, Ww, Wo, Wo, Wo, Wo, Wo, Wo, Ww, Ds, Gg^Vh, Gs^Fp, Hh, Ds, Gg, Ww, Ce, Ds, Gg, Gg, Gs^Fp, Ds, Ww, Wo
Wo, Wo, Wo, Wo, Wo, Wo, Wo, Ww, Ww, Ds, Hh, Hh, Gs^Fp, Gs^Fp, Gs^Fp, Gs^Fp, Gg, Ds, Ww, Wo, Wo, Wo, Wo, Wo, Wo, Wo, Ww, Ds, Gs^Fp, Hh, Gs^Fp, Gs^Fp, Ds, Ce, Ket, Gg, Ds, Gs^Fp, Ds, Ds, Ww, Wo
Wo, Wo, Wo, Wo, Wo, Wo, Wo, Ww, Ww, Ds, Ds, Gg^Vh, Gs^Fp, Gs^Fp, Gs^Fp, Gs^Fp, Gs^Fp, Ds, Ds, Ww, Ww, Wo, Wo, Wo, Wo, Wo, Ww, Ds, Ds, Gs^Fp, Ds, Gg^Vh, Ds, Ce, Ww, Ds, Gs^Fp, Gs^Fp, Gs^Fp, Ds, Ww, Wo
Wo, Wo, Wo, Wo, Wo, Wo, Wo, Ww, Ww, Ww, Ds, Gg, Gg, Gg, Gg, Gg, Gg, Gg^Vh, Gs^Fp, Ds, Ds, Ww, Ww, Ww, Ww, Ww, Ww, Ww, Ww, Ds, Ww, Ds, Ww, Ww, Ww, Ds, Ds, Gg^Vh, Ds, Ds, Ww, Wo
Wo, Wo, Wo, Wo, Wo, Wo, Wo, Wo, Wo, Ww, Ds, Gg, Gg, Gg, Gg, Gg, Gg, Gs^Fp, Gs^Fp, Gs^Fp, Gg, Ds, Ds, Ds, Ds, Ww, Ww, Wo, Wo, Ww, Wo, Ww, Ww, Ww, Ww, Ww, Ww, Ds, Ww, Ww, Wo, Wo
Wo, Wo, Wo, Wo, Wo, Wo, Wo, Wo, Wo, Ww, Ds, Gg, Gs^Fp, Gg, Gg, Gg, Gs^Fp, Gs^Fp, Gs^Fp, Gs^Fp, Gs^Fp, Gg, Gg, Gg^Vh, Gs^Fp, Ds, Ww, Wo, Wo, Wo, Wo, Wo, Ww, Ww, Ds, Ds, Ds, Ww, Wo, Wo, Wo, Wo
Wo, Wo, Wo, Wo, Wo, Wo, Wo, Wo, Wo, Ww, Ww, Ds, Gs^Fp, Gs^Fp, Hh, Gg, Gg, Gs^Fp, Gg, Gg, Gg, Gg, Gg, Gg, Gs^Fp, Ds, Ds, Ww, Ww, Wo, Ww, Ww, Ds, Ds, Gg, Gs^Fp, Gs^Fp, Ds, Wo, Wo, Wo, Wo
Wo, Wo, Wo, Wo, Wo, Wo, Wo, Wo, Wo, Wo, Ww, Ds, Gs^Fp, Gs^Fp, Hh, Hh, Hh, Gg, Gg, Gg, Ce, Ce, Ce, Gg, Gg, Gs^Fp, Ds, Ww, Ww, Ww, Ww, Ww, Ds, Gg^Vh, Ds, Gs^Fp, Ds, Ds, Wo, Wo, Wo, Wo
Wo, Wo, Wo, Wo, Wo, Wo, Wo, Wo, Wo, Ww, Ww, Ds, Ds, Gs^Fp, Gg^Vh, Hh, Gs^Fp, Gg, Gs^Fp, Gg, Ce, Ket, Ce, Gg, Gg, Gs^Fp, Ww, Ww, Ww, Ww, Wo, Ww, Ww, Ds, Ww, Ds, Ww, Ww, Wo, Wo, Wo, Wo
Wo, Wo, Wo, Wo, Wo, Wo, Wo, Wo, Wo, Ww, Ww, Ww, Ww, Ds, Ds, Gs^Fp, Gs^Fp, Gs^Fp, Gs^Fp, Gs^Fp, Gs^Fp, Ce, Gg, Gg, Ww^Bw\, Ww^Bw\, Ww, Ww, Wo, Wo, Wo, Wo, Wo, Ww, Wo, Ww, Wo, Ww, Wo, Wo, Wo, Wo
Wo, Wo, Wo, Wo, Wo, Wo, Wo, Wo, Wo, Wo, Wo, Ww, Ww, Ww, Ww, Ds, Ds, Ds, Ds, Ds, Ds, Gg, Ww^Bw\, Ww^Bw\, Ww, Ww, Ww, Ww, Wo, Wo, Wo, Wo, Wo, Wo, Wo, Wo, Wo, Wo, Wo, Wo, Wo, Wo
Wo, Wo, Wo, Wo, Wo, Wo, Wo, Wo, Wo, Wo, Wo, Wo, Wo, Ww, Ww, Ww, Ww, Ww, Ww, Ww, Ww, Ww, Ww, Ww, Ww, Ww, Wo, Wo, Wo, Wo, Wo, Wo, Wo, Wo, Wo, Wo, Wo, Wo, Wo, Wo, Wo, Wo
Wo, Wo, Wo, Wo, Wo, Wo, Wo, Wo, Wo, Wo, Wo, Wo, Wo, Wo, Wo, Ww, Wo, Ww, Wo, Ww, Wo, Ww, Wo, Ww, Wo, Wo, Wo, Wo, Wo, Wo, Wo, Wo, Wo, Wo, Wo, Wo, Wo, Wo, Wo, Wo, Wo, Wo
Wo, Wo, Wo, Wo, Wo, Wo, Wo, Wo, Wo, Wo, Wo, Wo, Wo, Wo, Wo, Wo, Wo, Wo, Wo, Wo, Wo, Wo, Wo, Wo, Wo, Wo, Wo, Wo, Wo, Wo, Wo, Wo, Wo, Wo, Wo, Wo, Wo, Wo, Wo, Wo, Wo, Wo
