Wo, Wo, Wo, Wo, Wo, Wo, Wo, Wo, Wo, Wo, Wo, Wo, Wo, Wo, Wo, Wo, Wo, Wo, Wo, Wo, Wo, Wo, Wo, Wo, Wo, Wo, Ww, Wo, Wo, Wo, Wo, Wo, Wo, Wo, Wo, Wo, Wo, Wo, Wo, Wo, Wo, Wo
Wo, Wo, Wo, Wo, Wo, Wo, Wo, Wo, Wo, Wo, Wo, Wo, Wo, Wo, Wo, Wo, Wo, Wo, Ww, Ww, Ww, Wo, Ww, Wo, Ww, Ww, Ds, Ww, Ww, Ww, Ww, Ww, Ww, Wo, Ww, Wo, Wo, Wo, Wo, Wo, Wo, Wo
Wo, Wo, Wo, Wo, Wo, Wo, Wo, Wo, Wo, Wo, Wo, Wo, Wo, Wo, Ww, Wo, Wo, Ww, Ds, Ds, Ww, Ww, Ds, Ww, Ds, Ww, Ds, Ds, Ds, Ds, Ds, Ds, Ds, Ww, Ds, Ww, Ww, Wo, Ww, Wo, Ww^Bw/, Ww^Bw/
Wo, Wo, Wo, Wo, Wo, Wo, Wo, Wo, Ww, Ww, Ww, Wo, Ww, Ww, Ds, Ww, Ww, Ww, Ds, Ds, Ds, Ds, Hh, Ds, Hh, Ds, Gs^Fp, Ds, Gs^Fp, Gs^Fp, Gs^Fp, Gs^Fp, Ce, Ds, Gg, Ds, Ds, Ww, Ww^Bw/, Ww^Bw/, Ww, Wo
Wo, Wo, Wo, Wo, Wo, Wo, Wo, Ww, Ds, Ds, Ds, Ww, Ds, Ww, Ds, Ds, Ds, Ds, Gs^Fp, Gs^Fp, Gg, Hh, Gg, Hh, Gs^Vo, Gg, Gs^Fp, Gs^Fp, Gg, Gs^Fp, Gs^Fp, Gs^Fp, Gg, Gg, Ke, Ce, Gg, Ww^Bw/, Ww, Ww, Wo, Wo
Wo, Wo, Wo, Wo, Wo, Wo, Wo, Ww, Ww, Ds, Gs^Fp, Ds, Ds, Ds, Gg, Ds, Gg, Gg, Gs^Fp, Gg, Gs^Fp, Gg, Gs^Fp, Gg^Efm, Gg^Efm, Gg^Efm, Gg^Efm, Gs^Fp, Gs^Fp, Gg^Efm, Gg^Efm, Gg^Efm, Gg, Ce, Ce, Ce, Ds, Ds, Ww, Wo, Wo, Wo
Wo, Wo, Wo, Wo, Wo, Wo, Ww, Ww, Ds, Ds, Gs^Fp, Gs^Fp, Gs^Fp, Gs^Fp, Gs^Fp, Hh, Gg, Gg^Efm, Gs^Fp, Gs^Fp, Gs^Fp, Gs^Fp, Gg, Gs^Fp, Gg^Efm, Gg^Efm, Hh, Gs^Fp, Hh, Gs^Fp, Gg, Gg, Ce, Gg, Gg, Gg, Ds, Ww, Wo, Wo, Wo, Wo
Wo, Wo, Wo, Wo, Wo, Wo, Ww, Ds, Ds, Gs^Vo, Hh, Hh, Hh, Gs^Fp, Hh, Hh, Gg^Efm, Gg^Efm, Gg^Efm, Gg^Efm, Gs^Fp, Gs^Fp, Gs^Fp, Gg, Gg, Gs^Fp, Hh, Hh, Hh, Hh, Gs^Vo, Gg, Ds, Gg, Ds, Ce, Wwf, Ww, Wo, Wo, Wo, Wo
Wo, Wo, Wo, Wo, Ww, Ww, Ds, Ds, Gg, Gg, Gs^Fp, Hh, Gg, Hh, Gg, Gg, Gg, Gg^Efm, Gg, Gg^Efm, Gs^Vo, Hh, Hh, Hh, Gg, Gs^Fp, Gs^Fp, Gs^Fp, Gg, Gs^Fp, Ds, Ds, Ww, Ds, Ww, Ds, Wwf, Ww, Ww, Wo, Wo, Wo
Wo, Wo, Wo, Wo, Ww, Ww, Ds, Ds, Gg, Gg, Gs^Fp, Gs^Fp, Gg, Gg, Gs^Fp, Gs^Fp, Hh, Gs^Fp, Hh, Gs^Fp, Gs^Fp, Hh, Ds, Ds, Wwf, Ds, Ds, Gg, Ds, Ds, Ww, Ww, Wo, Ww, Wo, Ww, Ds, Ds, Ds, Ww, Wo, Wo
Wo, Wo, Wo, Wo, Ww, Ds, Ww, Ds, Ds, Gs^Fp, Gs^Fp, Gs^Vo, Gg^Efm, Gg^Efm, Gg, Gs^Fp, Hh, Hh, Hh, Hh, Ds, Ds, Ww, Ww, Ww, Ww, Ww, Wwf, Ww, Ww, Ww, Wo, Wo, Wo, Wo, Ww, Ds, Gg, Ds, Ww, Wo, Wo
Wo, Wo, Wo, Wo, Wo, Ww, Ww, Ds, Ds, Gs^Fp, Gg, Gs^Fp, Gg^Efm, Gg^Efm, Gs^Fp, Hh, Gs^Fp, Gs^Fp, Ds, Gs^Fp, Ds, Ww, Wo, Ww, Wo, Ww, Ww, Ww, Wwf, Ww, Ww, Wo, Wo, Wo, Ww, Ww, Gg, Gs^Vo, Ds, Ww, Wo, Wo
Wo, Wo, Wo, Wo, Wo, Wo, Ww, Ww, Ds, Ds, Gg, Gg, Gs^Fp, Gg, Hh, Hh, Gg, Ds, Ww, Ds, Ww, Ww, Wo, Wo, Wo, Ww, Ds, Ds, Gg, Ds, Ds, Ww, Ww, Ww, Ww, Ds, Gg, Gg, Gs^Fp, Ww, Ww, Wo
Wo, Wo, Wo, Wo, Wo, Wo, Ww, Ww, Ds, Gg, Hh, Gs^Fp, Gs^Fp, Gs^Fp, Gs^Fp, Gg, Gg, Ds, Ww, Ww, Wo, Wo, Wo, Wo, Wo, Ww, Ds, Gg, Gs^Vo, Gs^Fp, Hh, Ds, Gg, Wwf, Ce, Ds, Hh, Hh, Gs^Fp, Ds, Ww, Wo
Wo, Wo, Wo, Wo, Wo, Ww, Ww, Ds, Ds, Ds, Hh, Hh, Gs^Fp, Gs^Fp, Gs^Fp, Gs^Fp, Gg, Ds, Ds, Ww, Wo, Wo, Wo, Wo, Wo, Ww, Ww, Ds, Gs^Fp, Hh, Gs^Fp, Gs^Fp, Ds, Gg, Ket, Gg, Hh, Gs^Fp, Gs^Fp, Ds, Ww, Wo
Wo, Wo, Wo, Wo, Wo, Ww, Ww, Ds, Ww, Ds, Gg, Gs^Vo, Gs^Fp, Gs^Fp, Hh, Gs^Fp, Gs^Fp, Gg, Ds, Ww, Ww, Wo, Ww, Wo, Wo, Wo, Ww, Ds, Gg, Gs^Fp, Gg, Gs^Vo, Ds, Ce, Wwf, Gs^Fp, Gs^Fp, Gs^Fp, Gs^Vo, Ds, Ww, Wo
Wo, Wo, Wo, Wo, Wo, Wo, Wo, Ww, Ww, Ds, Ds, Gg, Gg, Gg, Hh, Hh, Gg, Gs^Vo, Gs^Fp, Ds, Ds, Ww, Ds, Ww, Ww, Ww, Ww, Wwf, Ww, Ds, Ww, Ds, Ww, Wwf, Ww, Ds, Ds, Gs^Fp, Ds, Ds, Ww, Wo
Wo, Wo, Wo, Wo, Wo, Wo, Wo, Ww, Ww, Ds, Ds, Gg, Gs^Fp, Gg^Efm, Gg^Efm, Gg^Efm, Gg^Efm, Gs^Fp, Gs^Fp, Gs^Fp, Hh, Ds, Gg, Ds, Gg, Wwf, Ww, Ww, Wo, Ww, Wo, Ww, Ww, Ww, Ww, Ww, Ww, Wwf, Ww, Ww, Wo, Wo
Wo, Wo, Wo, Wo, Wo, Wo, Wo, Wo, Ww, Ww, Ds, Gs^Fp, Gs^Fp, Gg, Hh, Gg^Efm, Gs^Fp, Gs^Fp, Hh, Hh, Gs^Fp, Gg, Gg, Gs^Vo, Gs^Fp, Ds, Ww, Wo, Wo, Wo, Ww, Ww, Ds, Wwf, Ds, Wwf, Ds, Ww, Ww, Ww, Wo, Wo
Wo, Wo, Wo, Wo, Wo, Wo, Wo, Wo, Ww, Ds, Ds, Ds, Gs^Fp, Gs^Fp, Hh, Gg, Gg^Efm, Gs^Fp, Gg^Efm, Hh, Gg, Gg, Ce, Gg, Gs^Fp, Ds, Ds, Ww, Ww, Ww, Gg, Ds, Gg, Gs^Fp, Gs^Fp, Gs^Fp, Gs^Fp, Ds, Ww, Wo, Wo, Wo
Wo, Wo, Wo, Wo, Wo, Wo, Wo, Wo, Wo, Ww, Ww, Ds, Ds, Gs^Fp, Hh, Hh, Hh, Gg^Efm, Gg^Efm, Gg^Efm, Ce, Gg, Ce, Gg, Gg, Gs^Fp, Ds, Wwf, Ww, Wwf, Ds, Gs^Fp, Gs^Fp, Gs^Vo, Gs^Fp, Gs^Fp, Ds, Ds, Ww, Wo, Wo, Wo
Wo, Wo, Wo, Wo, Wo, Wo, Wo, Wo, Wo, Ww, Ds, Ds, Ds, Gs^Fp, Gs^Vo, Gg, Gs^Fp, Gs^Fp, Gs^Fp, Gs^Fp, Gg, Ket, Ce, Ce, Gg, Gs^Fp, Ww, Ww, Ww, Ww, Ww, Gs^Fp, Ds, Ds, Ww, Ds, Ww, Ww, Wo, Wo, Wo, Wo
Wo, Wo, Wo, Wo, Wo, Wo, Wo, Wo, Wo, Ww, Ww, Ds, Ww, Ds, Ds, Ds, Ds, Gs^Fp, Ds, Gs^Fp, Gs^Fp, Ce, Gg, Gg, Ww^Bw\, Ww^Bw\, Ww, Ww, Wo, Wo, Wo, Ww, Ww, Ww, Wo, Ww, Wo, Ww, Wo, Wo, Wo, Wo
Wo, Wo, Wo, Wo, Wo, Wo, Wo, Wo, Wo, Wo, Wo, Ww, Ww, Ww, Ds, Ds, Ww, Ds, Ds, Ds, Ds, Gg, Ww^Bw\, Ww^Bw\, Ww, Ww, Ww, Ww, Wo, Wo, Wo, Wo, Wo, Wo, Wo, Wo, Wo, Wo, Wo, Wo, Wo, Wo
Wo, Wo, Wo, Wo, Wo, Wo, Wo, Wo, Wo, Wo, Wo, Wo, Wo, Ww, Ww, Ww, Ww, Ww, Ww, Ww, Ww, Ww, Ww, Ww, Ww, Ww, Wo, Wo, Wo, Wo, Wo, Wo, Wo, Wo, Wo, Wo, Wo, Wo, Wo, Wo, Wo, Wo
Wo, Wo, Wo, Wo, Wo, Wo, Wo, Wo, Wo, Wo, Wo, Wo, Wo, Wo, Wo, Wo, Wo, Ww, Ww, Ww, Ww, Ww, Wo, Ww, Wo, Wo, Wo, Wo, Wo, Wo, Wo, Wo, Wo, Wo, Wo, Wo, Wo, Wo, Wo, Wo, Wo, Wo
Wo, Wo, Wo, Wo, Wo, Wo, Wo, Wo, Wo, Wo, Wo, Wo, Wo, Wo, Wo, Wo, Wo, Wo, Wo, Wo, Wo, Wo, Wo, Wo, Wo, Wo, Wo, Wo, Wo, Wo, Wo, Wo, Wo, Wo, Wo, Wo, Wo, Wo, Wo, Wo, Wo, Wo
