Wo, Wo, Wo, Wo, Wo, Wo, Wo, Wo, Wo, Wo, Wo, Wo, Wo, Wo, Wo, Wo, Wo, Wo, Wo, Wo, Wo, Wo, Wo, Wo, Wo, Wo, Wo, Wo, Wo, Wo, Wo, Wo, Wo, Wo, Wo, Wo, Wo, Wo, Wo
Wo, Wo, Wo, Wo, Wo, Wo, Wo, Wo, Wo, Wo, Wo, Wo, Wo, Wo, Wo, Wo, Wo, Wo, Wo, Wo, Wo, Wo, Wo, Wo, Wo, Wo, Wo, Wo, Wo, Wo, Wo, Wo, Wo, Wo, Wo, Wo, Wo, Wo, Wo
Wo, Wo, Wo, Wo, Wo, Wo, Wo, Wo, Wo, Wo, Wo, Wo, Wo, Wo, Wo, Wo, Wo, Wo, Wo, Wo, Wo, Wo, Wo, Wo, Ww, Wo, Ww, Ww, Ww, Ww, Ww, Ww, Ww, Wo, Wo, Wo, Wo, Wo, Wo
Wo, Wo, Wo, Wo, Ww, Ww, Ww, Ww, Ww, Wo, Ww, Wo, Wo, Wo, Ww, Wo, Wo, Wo, Wo, Wo, Ww, Ww, Ww, Ww, Ww, Ww, Dd, Ww, Dd, Dd, Dd, Ww, Ww, Ww, Wo, Wo, Wo, Wo, Wo
Wo, Wo, Wo, Ww, Ww, Ww, Dd, Ww, Dd, Ww, Ww, Ww, Ww, Ww, Ww, Ww, Ww, Ww, Ww, Ww, Ww, Ww, Dd, Dd, Dd, Dd, Gs, Dd, Gs^Ft, Dd, Dd, Dd, Ww, Ww, Wo, Wo, Wo, Wo, Wo
Wo, Wo, Ww, Ww, Dd, Dd, Gs, Dd, Dd, Dd, Dd, Dd, Dd, Dd, Dd, Ww, Ww, Ww, Dd, Ww, Dd, Dd, Rr^Vd, Gs, Hh, Gs, Hh, Gs^Ft, Gs^Ft, Gs^Ft, Dd, Dd, Ww, Ww, Wo, Wo, Wo, Wo, Wo
Wo, Wo, Ww, Ww, Dd, Dd, Gs^Ft, Gs^Ft, Gs^Ft, Gs^Ft, Gs, Rr^Vd, Gs, Dd, Dd, Dd, Wwf, Dd, Wwf, Wwf, Dd, Dd, Gs, Hh, Gs, Hh, Mm, Hh, Hh, Rr^Vd, Dd, Dd, Ww, Ww, Wo, Wo, Wo, Wo, Wo
Wo, Wo, Ww, Dd, Dd, Dd, Gs, Gs^Ft, Rr^Vd, Gs^Ft, Gs^Ft, Gs^Ft, Hh, Gs, Gs^Ft, Gs, Dd, Wwf, Wwf, Dd, Gs^Ft, Gs, Gs^Ft, Gs^Ft, Gs, Hh, Hh, Mm, Hh, Gs, Dd, Ww, Ww, Ww, Wo, Wo, Wo, Wo, Wo
Wo, Wo, Wo, Ww, Ww, Dd, Dd, Gs, Hh, Gs, Hh, Gs^Ft, Hh, Gs, Gs, Dd, Gs, Wwf, Wwf, Gs, Gs^Ft, Gs^Ft, Gs, Gs, Gs^Ft, Gs, Rr^Vd, Gs, Gs, Gs, Gs, Dd, Ww, Ww, Ww, Wo, Wo, Wo, Wo
Wo, Wo, Wo, Ww, Ww, Dd, Dd, Gs, Hh, Hh, Chr, Mm, Hh, Gs^Ft, Rr^Vd, Gs^Ft, Gs^Ft, Dd, Wwf, Dd, Dd, Gs^Ft, Dd, Gs^Ft, Dd, Hh, Hh, Hh, Hh, Gs, Gs^Ft, Dd, Dd, Dd, Dd, Ww, Wo, Wo, Wo
Wo, Wo, Ww, Ww, Ww, Ww, Dd, Dd, Gs, Mm, Khr, Chr, Mm, Gs^Ft, Hh, Gs^Ft, Gs^Ft, Gs, Dd, Ww, Ww, Dd, Ww, Ww, Ww, Gs, Hh, Mm, Hh, Gs, Gs, Gs^Ft, Gs, Dd, Ww, Ww, Wo, Wo, Wo
Wo, Wo, Ww, Ww, Ww, Dd, Dd, Gs, Gs, Hh, Mm, Chr, Hh, Hh, Gs^Ft, Gs^Ft, Gs^Ft, Gs, Dd, Ww, Wo, Ww, Wo, Wo, Ww, Dd, Gs, Hh, Mm, Hh, Gs, Gs^Ft, Gs^Ft, Dd, Ww, Ww, Ww, Wo, Wo
Wo, Wo, Ww, Ww, Dd, Ww, Dd, Dd, Gs^Ft, Gs^Ft, Mm, Mm, Mm, Gs, Gs, Gs^Ft, Gs, Gs, Rr^Vd, Ww, Ww, Wo, Wo, Wo, Ww, Ww, Dd, Hh, Hh, Hh, Gs, Gs^Ft, Gs^Ft, Dd, Dd, Ww, Ww, Wo, Wo
Wo, Wo, Ww, Ww, Dd, Dd, Dd, Dd, Gs, Hh, Hh, Hh, Hh, Hh, Gs, Gs, Gs^Ft, Gs^Ft, Hh, Dd, Ww, Ww, Ww, Ww, Dd, Ww, Dd, Gs, Gs, Gs, Ce, Gs, Gs, Dd, Dd, Ww, Ww, Wo, Wo
Wo, Wo, Ww, Ww, Ww, Dd, Dd, Gs, Gs^Ft, Gs, Gs, Gs, Gs, Rr^Vd, Gs, Gs^Ft, Gs^Ft, Gs, Hh, Dd, Dd, Dd, Dd, Ww, Gs, Gs^Ft, Gs^Ft, Rr^Vd, Gs, Ce, Ce, Ke, Gs, Dd, Dd, Ww, Ww, Wo, Wo
Wo, Wo, Wo, Ww, Ww, Dd, Dd, Dd, Gs^Ft, Gs^Ft, Gs^Ft, Gs^Ft, Hh, Gs, Gs, Gs^Ft, Gs, Gs, Hh, Hh, Gs^Ft, Gs^Ft, Dd, Wwf, Dd, Gs^Ft, Gs^Ft, Gs, Hh, Mm, Mm, Gs, Gs, Dd, Ww, Ww, Ww, Wo, Wo
Wo, Wo, Wo, Ww, Dd, Dd, Dd, Gs^Ft, Rr^Vd, Gs^Ft, Gs^Ft, Hh, Mm, Hh, Mm, Hh, Hh, Hh, Hh, Gs, Gs, Gs^Ft, Wwf, Wwf, Ww, Dd, Gs^Ft, Gs^Ft, Gs^Ft, Hh, Hh, Hh, Dd, Dd, Ww, Ww, Wo, Wo, Wo
Wo, Wo, Wo, Ww, Ww, Dd, Dd, Dd, Dd, Dd, Dd, Gs, Dd, Hh, Gs, Hh, Hh, Mm, Gs, Hh, Dd, Dd, Ww, Ww, Dd, Dd, Dd, Dd, Dd, Gs, Dd, Gs, Dd, Dd, Ww, Ww, Wo, Wo, Wo
Wo, Wo, Wo, Wo, Ww, Dd, Dd, Dd, Ww, Dd, Dd, Dd, Ww, Dd, Dd, Dd, Dd, Gs, Dd, Dd, Dd, Ww, Ww, Ww, Ww, Dd, Ww, Dd, Ww, Dd, Ww, Dd, Ww, Ww, Ww, Ww, Wo, Wo, Wo
Wo, Wo, Wo, Wo, Wo, Ww, Ww, Ww, Ww, Ww, Ww, Ww, Ww, Ww, Ww, Ww, Ww, Dd, Ww, Dd, Ww, Ww, Wo, Ww, Wo, Ww, Ww, Ww, Ww, Ww, Ww, Ww, Ww, Ww, Wo, Wo, Wo, Wo, Wo
Wo, Wo, Wo, Wo, Wo, Wo, Wo, Wo, Wo, Wo, Wo, Wo, Wo, Wo, Wo, Ww, Ww, Ww, Wo, Ww, Wo, Wo, Wo, Wo, Wo, Wo, Wo, Wo, Wo, Wo, Wo, Wo, Wo, Wo, Wo, Wo, Wo, Wo, Wo
Wo, Wo, Wo, Wo, Wo, Wo, Wo, Wo, Wo, Wo, Wo, Wo, Wo, Wo, Wo, Wo, Wo, Wo, Wo, Wo, Wo, Wo, Wo, Wo, Wo, Wo, Wo, Wo, Wo, Wo, Wo, Wo, Wo, Wo, Wo, Wo, Wo, Wo, Wo
Wo, Wo, Wo, Wo, Wo, Wo, Wo, Wo, Wo, Wo, Wo, Wo, Wo, Wo, Wo, Wo, Wo, Wo, Wo, Wo, Wo, Wo, Wo, Wo, Wo, Wo, Wo, Wo, Wo, Wo, Wo, Wo, Wo, Wo, Wo, Wo, Wo, Wo, Wo
Wo, Wo, Wo, Wo, Wo, Wo, Wo, Wo, Wo, Wo, Wo, Wo, Wo, Wo, Wo, Wo, Wo, Wo, Wo, Wo, Wo, Wo, Wo, Wo, Wo, Wo, Wo, Wo, Wo, Wo, Wo, Wo, Wo, Wo, Wo, Wo, Wo, Wo, Wo
