Wo, Wo, Wo, Wo, Wo, Wo, Wo, Wo, Wo, Wo, Wo, Wo, Wo, Wo, Wo, Wo, Wo, Wo, Wo, Wo, Wo, Wo, Wo, Wo, Wo, Wo, Wo, Wo, Wo, Wo, Wo, Wo
Wo, Wo, Wo, Wo, Wo, Wo, Wo, Wo, Wo, Wo, Wo, Wo, Wo, Wo, Wo, Wo, Wo, Wo, Wo, Wo, Wo, Wo, Wo, Wo, Wo, Wo, Wo, Wo, Wo, Wo, Wo, Wo
Wo, Wo, Wo, Wo, Wo, Wo, Wo, Wo, Wo, Wo, Wo, Wo, Wo, Wo, Wo, Wo, Wo, Wo, Wo, Wo, Wo, Wo, Wo, Wo, Wo, Wo, Wo, Wo, Wo, Wo, Wo, Wo
Wo, Wo, Wo, Wo, Wo, Wo, Wo, Wo, Ww, Wo, Wwr, Wo, Wo, Wo, Wo, Wo, Wo, Wo, Ww, Wo, Ww, Wo, Wo, Wo, Wo, Wo, Wo, Wo, Wo, Wo, Wo, Wo
Wo, Wo, Wo, Wo, Wo, Wo, Wo, Wo, Wwr, Wwr, Ww, Wwr, Ww, Wwr, Ww, Ww, Wwr, Wwr, Ww, Wwr, Ww, Wwr, Wwr, Wo, Ww, Wo, Wo, Wo, Wo, Wo, Wo, Wo
Wo, Wo, Wo, Wo, Wo, Wo, Ww, Wwr, Ww, Ww, Ww, Ww, Ww, Ww, Ww, Ww, Ww, Ww, Ww, Ww, Ww, Ww, Ww, Ww, Ww, Wwr, Wwr, Ww, Wo, Wo, Wo, Wo
Wo, Wo, Wo, Wo, Wo, Wo, Wwr, Wwr, Ww, Ww, Ds, Ds, Ds, Ds, Ds, Ww, Ds, Ww, Wwf, Ds, Ww, Ww, Ww, Ww, Ww, Ww, Ww, Wwr, Wwr, Wo, Wo, Wo
Wo, Wo, Wo, Wo, Wo, Wwr, Ww, Ww, Ww, Ww, Wwf, Ds, Gs^Ve, Gg, Gs^Fp, Ds, Gs^Fp, Ds, Gg, Ds, Ds, Ds, Ds, Ds, Ds, Ww, Ww, Ww, Ww, Wo, Wo, Wo
Wo, Wo, Wo, Wo, Ww, Wwr, Ww, Ww, Ds, Ww, Ds, Gg, Gg, Gg, Gs^Fp, Gs^Fp, Hh, Hh, Mm, Hh, Gs^Fp, Gg, Gs^Fp, Ds, Gg, Wwf, Ds, Ww, Ww, Ww, Ww, Wo
Wo, Wo, Wo, Wo, Wwr, Ww, Ww, Ds, Ds, Ds, Gs^Fp, Gs^Fp, Gg^Efm, Gs^Fp, Gs^Fp, Gg, Hh, Mm, Gs^Fp, Hh, Gs^Fp, Gs^Fp, Gs^Fp, Gg, Gs^Ve, Gg, Gs^Fp, Ds, Ww, Wwr, Wwr, Wo
Wo, Wo, Wo, Wo, Wwr, Ww, Ds, Ds, Ds, Gg, Gg, Gs^Fp, Gg^Efm, Gg^Efm, Gg^Efm, Gg^Efm, Gg, Hh, Gg, Gs^Fp, Gg, Gg, Gg, Gg^Efm, Gg^Efm, Gs^Fp, Gs^Fp, Ds, Ds, Ww, Wwr, Wo
Wo, Wo, Wo, Ww, Wwr, Ww, Ww, Ds, Gs^Fp, Gs^Fp, Gg^Efm, Gs^Fp, Gg^Efm, Gg^Efm, Gg, Gg, Gg, Gg^Efm, Gg^Efm, Gg^Efm, Gg^Efm, Ce, Ce, Gg^Efm, Gs^Fp, Gs^Fp, Ds, Ds, Ww, Ww, Wwr, Wo
Wo, Wo, Wo, Ww, Ww, Ww, Wwf, Ds, Gg, Gg^Efm, Gg^Efm, Gg, Gs^Fp, Gs^Fp, Hh, Hh, Gs^Fp, Gs^Fp, Gg^Efm, Gs^Fp, Gg, Re, Ke, Re, Gg, Ds, Ds, Ds, Ww, Ww, Ww, Wo
Wo, Wo, Ww, Wwr, Ww, Ww, Ds, Gg, Gs^Fp, Gs^Ve, Gg, Gs^Fp, Gs^Fp, Gs^Fp, Hh, Mm, Hh, Gs^Fp, Gg, Gg, Gg, Ce, Gg, Ce, Ds, Ds, Ww, Ww, Ww, Wwr, Wo, Wo
Wo, Wo, Wwr, Ww, Ww, Ww, Ds, Gs^Fp, Hh, Hh, Hh, Gg, Gg^Efm, Gg, Gg, Hh, Hh, Gg, Hh, Gs^Ve, Ds, Ds, Wwf, Ds, Ds, Ds, Ww, Ww, Wwr, Wwr, Wo, Wo
Wo, Wwr, Ww, Ww, Ww, Ds, Gg, Gg^Efm, Hh, Mm, Gs^Fp, Gs^Fp, Gg^Efm, Gg^Efm, Gs^Ve, Gg, Hh, Hh, Hh, Gg, Ds, Ww, Ww, Ww, Ww, Ww, Ww, Ww, Ww, Wo, Wo, Wo
Wwr, Wwr, Ww, Ds, Ds, Ds, Gg^Efm, Hh, Mm, Hh, Gs^Fp, Gs^Fp, Gg, Gg^Efm, Gs^Fp, Gs^Fp, Gs^Fp, Hh, Mm, Hh, Gg, Wwf, Wwf, Ww, Ww, Ww, Ww, Wwr, Wo, Wo, Wo, Wo
Wwr, Ww, Ww, Ww, Ds, Gs^Fp, Gs^Fp, Hh, Hh, Gs^Fp, Gg, Gg^Efm, Gg, Gg, Gs^Fp, Gs^Fp, Hh, Hh, Mm, Hh, Hh, Ds, Gg, Ds, Ds, Ww, Ww, Wwr, Wo, Wo, Wo, Wo
Wwr, Ww, Ww, Ww, Ds, Gs^Fp, Gs^Ve, Gs^Fp, Gg^Efm, Gg^Efm, Gg^Efm, Gg^Efm, Gg^Efm, Gs^Fp, Gs^Fp, Gg^Efm, Gg, Hh, Hh, Mm, Gs^Fp, Hh, Gs^Ve, Gs^Fp, Ds, Ww, Ww, Wwr, Wo, Wo, Wo, Wo
Wo, Wwr, Ww, Ds, Ww, Ds, Ds, Gs^Fp, Gg, Cv, Kv, Cv, Gg^Efm, Gg, Gs^Fp, Gg^Efm, Gg, Gs^Fp, Gs^Fp, Hh, Ds, Gs^Fp, Ds, Ds, Ww, Ww, Wo, Wo, Wo, Wo, Wo, Wo
Wo, Wwr, Wwr, Ww, Ww, Ds, Wwf, Gg, Gg, Gg^Efm, Cv, Cv, Cv, Gs^Fp, Ds, Gs^Fp, Ds, Gs^Ve, Ds, Ds, Ds, Ds, Ds, Ds, Ww, Wwr, Wo, Wo, Wo, Wo, Wo, Wo
Wo, Wo, Wo, Wwr, Ww, Ww, Ww, Ds, Ds, Cv, Gg^Efm, Gg^Efm, Gs^Fp, Ds, Ww, Ds, Ds, Ds, Ww, Ww, Ww, Ww, Ww, Ww, Wwr, Wo, Wo, Wo, Wo, Wo, Wo, Wo
Wo, Wo, Wo, Ww, Wwr, Ww, Ww, Ww, Ds, Gs^Fp, Gg, Ds, Ds, Ds, Ww, Ww, Ds, Ds, Ww, Ww, Wwr, Wwr, Ww, Wwr, Wo, Wo, Wo, Wo, Wo, Wo, Wo, Wo
Wo, Wo, Wo, Wo, Ww, Wwr, Wwr, Ww, Ww, Ds, Wwf^Bw|, Wwf, Ww, Ww, Ww, Ww, Ww, Ww, Wwr, Ww, Wo, Wo, Wo, Wo, Wo, Wo, Wo, Wo, Wo, Wo, Wo, Wo
Wo, Wo, Wo, Wo, Wo, Ww, Wo, Ww, Ww, Ww, Ww^Bw|, Ww, Ww, Ww, Wwr, Ww, Wwr, Wwr, Wo, Wo, Wo, Wo, Wo, Wo, Wo, Wo, Wo, Wo, Wo, Wo, Wo, Wo
Wo, Wo, Wo, Wo, Wo, Wo, Wo, Wwr, Wwr, Ww, Ww^Bw|, Ww, Wwr, Wo, Wo, Wo, Wo, Wo, Wo, Wo, Wo, Wo, Wo, Wo, Wo, Wo, Wo, Wo, Wo, Wo, Wo, Wo
Wo, Wo, Wo, Wo, Wo, Wo, Wo, Wo, Wo, Ww, Ww^Bw|, Ww, Wo, Wo, Wo, Wo, Wo, Wo, Wo, Wo, Wo, Wo, Wo, Wo, Wo, Wo, Wo, Wo, Wo, Wo, Wo, Wo
Wo, Wo, Wo, Wo, Wo, Wo, Wo, Wo, Wo, Ww, Ww^Bw|, Ww, Wo, Wo, Wo, Wo, Wo, Wo, Wo, Wo, Wo, Wo, Wo, Wo, Wo, Wo, Wo, Wo, Wo, Wo, Wo, Wo
