Wo, Wo, Wo, Wo, Wo, Wo, Wo, Wo, Wo, Wo, Wo, Wo, Wo, Wo, Ww, Ww^Bw|, Ww, Wo, Wo, Wo, Wo, Wo, Wo, Wo, Wo, Wo, Wo, Wo, Wo, Wo, Wo, Wo, Wo, Wo, Wo, Wo, Wo, Wo, Wo, Wo, Wo, Wo, Wo, Wo, Wo, Wo, Wo, Wo, Wo
Wo, Wo, Wo, Wo, Wo, Wo, Wo, Wo, Wo, Wo, Wo, Wo, Wo, Wo, Ww, Ww^Bw|, Ww, Wo, Wo, Wo, Wo, Wo, Wo, Wo, Ww, Wo, Ww, Wo, Wo, Wo, Wo, Wo, Wo, Wo, Wo, Wo, Wo, Wo, Wo, Wo, Wo, Wo, Wo, Wo, Wo, Wo, Wo, Wo, Wo
Wo, Wo, Wo, Wo, Wo, Wo, Wo, Wo, Wo, Wo, Wo, Wo, Wwr, Ww, Ww, Ww^Bw|, Ww, Ww, Wwr, Wo, Ww, Wo, Wwr, Wwr, Ww, Wwr, Ww, Wwr, Wwr, Ww, Wo, Wo, Wo, Wo, Wo, Wo, Wo, Wo, Wo, Wo, Wo, Wo, Wo, Wo, Wo, Wo, Wo, Wo, Wo
Wo, Wo, Wo, Wo, Wo, Wo, Wo, Wo, Wo, Wo, Wo, Ww, Wwr, Ww, Ww, Ww^Bw|, Ww, Ww, Ww, Wwr, Ww, Wwr, Ww, Ww, Ww, Ww, Ww, Ww, Ww, Wwr, Ww, Wo, Wo, Wo, Wo, Wo, Wo, Wo, Wo, Wo, Wwr, Wo, Ww, Wo, Wo, Wo, Wo, Wo, Wo
Wo, Wo, Wo, Wo, Wo, Wo, Wo, Wo, Ww, Wo, Ww, Wwr, Ww, Ww, Ds, Ww^Bw|, Ds, Ww, Ds, Ww, Ww, Ww, Ds, Ww, Ds, Ds, Ds, Ds, Ww, Ww, Ww, Ww, Wwr, Ww, Wwr, Ww, Wwr, Wwr, Ww, Ww, Ww, Wwr, Wwr, Ww, Wo, Wo, Wo, Wo, Wo
Wo, Wo, Wo, Wo, Wo, Wo, Wo, Wo, Wwr, Wwr, Ww, Ww, Ww, Ww, Ds, Gg, Re, Ds, Wwf, Ww, Ds, Wwf, Gg, Ds, Gs^Fp, Ds, Gs^Fp, Ds, Ds, Ww, Ww, Ww, Ww, Ww, Ww, Wwr, Ww, Ww, Ww, Ww, Ww, Ww, Ww, Wwr, Ww, Wo, Wo, Wo, Wo
Wo, Wo, Wo, Wo, Wo, Wo, Wo, Ww, Ww, Ww, Ww, Ww, Ds, Wwf, Gg, Ce, Ce, Gg, Ds, Ww, Ds, Gg, Gs^Ve, Gg^Efm, Gs^Fp, Gs^Fp, Gs^Fp, Ds, Ds, Ww, Ds, Ww, Ww, Ww, Ww, Ww, Ww, Ww, Ds, Ds, Ww, Ww, Ww, Ww, Wwr, Ww, Wo, Wo, Wo
Wo, Wo, Wo, Wo, Wo, Wo, Wwr, Wwr, Ww, Ww, Ww, Ww, Wwf, Ds, Ce, Ce, Ke, Re, Gg, Ds, Gg, Hh, Mm, Hh, Mm, Hh, Hh, Gs^Fp, Ds, Ds, Wwf, Ww, Ds, Ds, Ww, Ww, Ds, Ww, Ds, Ds, Ds, Ds, Ww, Ww, Ww, Ww, Wwr, Wo, Wo
Wo, Wo, Wo, Wo, Wo, Ww, Wwr, Ww, Ww, Ds, Ds, Ww, Ds, Gg, Gs^Fp, Re, Ce, Ce, Gg, Hh, Mm, Mm, Hh, Mm, Hh, Gs^Fp, Gs^Fp, Gs^Fp, Gs^Fp, Gg, Wwf, Wwf, Gs^Fp, Ds, Ds, Ds, Ds, Ds, Gs^Vo, Ds, Gg, Ds, Ds, Ww, Ww, Ww, Ww, Wwr, Wo
Wo, Wo, Wo, Wo, Wwr, Wwr, Ww, Ww, Ds, Ds, Ds, Ds, Gg^Efm, Gs^Fp, Hh, Gs^Fp, Gg^Efm, Gg^Efm, Gg^Efm, Hh, Gs^Fp, Hh, Gg, Gs^Ve, Gg^Efm, Gs^Fp, Gg^Efm, Gg, Wwf, Wwf, Wwf, Gg, Gg, Gs^Fp, Hh, Gs^Fp, Hh, Hh, Hh, Gs^Fp, Gs^Fp, Ds, Ds, Ww, Ds, Ww, Ww, Wwr, Wo
Wo, Wo, Wo, Ww, Ww, Ww, Ww, Ww, Ww, Wwf, Gg, Gs^Ve, Hh, Hh, Mm, Gg, Gs^Fp, Gs^Fp, Gg^Efm, Gs^Fp, Gg^Efm, Gg, Gs^Fp, Gg^Efm, Gs^Fp, Gg^Efm, Gs^Fp, Ds, Ww, Ww, Ww, Wwf, Ds, Gg, Hh, Mm, Mm, Mm, Hh, Gs^Fp, Mm, Gs^Fp, Gs^Fp, Ds, Ds, Ww, Ww, Ww, Ww
Wo, Wo, Wo, Wwr, Ww, Ww, Ww, Ds, Ds, Ds, Gs^Fp, Gg, Mm, Mm, Hh, Hh, Gs^Fp, Gs^Fp, Gg^Efm, Gg^Efm, Gg^Efm, Gs^Fp, Hh, Gs^Fp, Gs^Fp, Gs^Fp, Ds, Ds, Ww, Ww, Ww, Ww, Ds, Gs^Fp, Hh, Mm, Hh, Hh, Co, Hh, Hh, Hh, Gs^Fp, Ds, Ww, Ww, Ww, Ww, Ww
Wo, Wo, Ww, Wwr, Ww, Ww, Ds, Ds, Gg, Gs^Fp, Gs^Fp, Hh, Mm, Hh, Gs^Ve, Gg, Gg^Efm, Gg, Gs^Fp, Gg, Gs^Ve, Gg, Mm, Hh, Gs^Fp, Gg, Wwf, Ww, Ww, Ww, Wwf, Ds, Gs^Fp, Gs^Fp, Gs^Fp, Hh, Co, Mm, Ko, Co, Co, Gs^Fp, Gg, Ds, Ds, Ww, Ww, Wwr, Ww
Wo, Wo, Wwr, Ww, Ww, Ww, Ds, Ds, Gg, Gs^Fp, Gg^Efm, Hh, Mm, Hh, Gg, Gs^Fp, Gs^Fp, Gg^Efm, Gs^Fp, Gs^Fp, Gs^Fp, Hh, Mm, Hh, Gg, Ds, Ww, Ww, Wwf, Ww, Ds, Gg, Hh, Gg, Hh, Hh, Hh, Co, Hh, Mm, Hh, Gg, Gg, Wwf, Ww, Ww, Ww, Wwr, Wo
Wo, Ww, Wwr, Ww, Ww, Ds, Ds, Ds, Gs^Ve, Gs^Fp, Gs^Fp, Hh, Hh, Hh, Gg, Gs^Fp, Gg, Gg^Efm, Gg, Gs^Fp, Hh, Mm, Hh, Gs^Fp, Ds, Wwf, Wwf, Ds, Gg, Ds, Gs^Vo, Gg, Mm, Mm, Mm, Mm, Hh, Hh, Mm, Hh, Gs^Fp, Gg, Ds, Ds, Ww, Ww, Wwr, Ww, Wo
Wo, Ww, Wwr, Ww, Ww, Ww, Ww, Ds, Ds, Gg, Ds, Gg, Wwf, Ds, Wwf, Wwf, Wwf, Ds, Wwf, Gg, Hh, Hh, Ds, Gg, Wwf, Ww, Ds, Gg, Hh, Gs^Fp, Hh, Hh, Mm, Mm, Hh, Hh, Mm, Mm, Hh, Gs^Vo, Gg, Ds, Ds, Ww, Ww, Ww, Wwr, Ww, Wo
Wo, Wo, Ww, Wwr, Ww, Ww, Ds, Ds, Ds, Wwf, Ww, Wwf, Ww, Ww, Wwf, Ww, Wwf, Ww, Wwf, Wwf, Ww, Gg, Ww, Wwf, Ds, Wwf, Gg, Hh, Mm, Hh, Mm, Mm, Mm, Mm, Hh, Hh, Mm, Hh, Gs^Fp, Gg, Ds, Ds, Ww, Ds, Ww, Ww, Wwr, Wo, Wo
Wo, Wo, Wo, Ww, Ww, Ww, Ww, Ww, Ww, Ww, Ds, Wwf, Ds, Ds, Gg, Wwf, Gs^Fp, Ds, Gs^Fp, Wwf, Ds, Wwf, Ds, Wwf, Gg, Gs^Fp, Hh, Hh, Mm, Mm, Mm, Mm, Hh, Hh, Mm, Mm, Hh, Hh, Hh, Gs^Fp, Ds, Ds, Ww, Ww, Ww, Ww, Ww, Wo, Wo
Wo, Wo, Wo, Wwr, Ww, Ww, Ww, Ww, Ww, Wwf, Hh, Gg, Gs^Fp, Gg^Efm, Gs^Fp, Gg, Gs^Ve, Hh, Mm, Gs^Fp, Hh, Gs^Fp, Hh, Gs^Fp, Hh, Gs^Fp, Hh, Mm, Hh, Hh, Hh, Hh^Vo, Hh, Mm, Mm, Hh, Hh, Gs^Fp, Gs^Fp, Gg, Wwf, Ds, Ds, Ww, Ww, Wwr, Wo, Wo, Wo
Wo, Wo, Wo, Ww, Ww, Ww, Ds, Ds, Ds, Ds, Hh, Hh, Gg^Efm, Gs^Fp, Gs^Fp, Gs^Fp, Gg^Efm, Hh, Hh, Mm, Mm, Mm, Mm, Mm, Hh, Gg, Gs^Fp, Hh, Mm, Mm, Hh, Hh, Hh, Hh, Mm, Hh, Gs^Vo, Gs^Fp, Ds, Ds, Ww, Ww, Ww, Ww, Wwr, Ww, Wo, Wo, Wo
Wo, Wo, Wo, Ww, Ww, Ww, Ww, Ds, Gg, Gs^Ve, Gg^Efm, Mm, Hh, Gs^Fp, Gs^Fp, Gg^Efm, Gs^Fp, Gs^Fp, Gs^Fp, Gs^Fp, Gs^Ve, Hh, Hh, Hh, Gg^Efm, Gg^Efm, Hh, Hh, Mm, Hh, Hh, Mm, Hh, Gg, Hh, Mm, Hh, Gg, Ds, Ds, Ds, Ww, Ww, Ww, Wwr, Wo, Wo, Wo, Wo
Wo, Wo, Ww, Wwr, Ww, Ww, Ds, Ds, Gs^Fp, Gs^Fp, Hh, Hh, Gg^Efm, Gg^Efm, Gs^Fp, Gs^Fp, Gg^Efm, Gg, Gg, Gs^Fp, Gs^Fp, Hh, Gg^Efm, Gs^Fp, Gg^Efm, Gs^Fp, Gs^Fp, Gs^Vo, Hh, Gg, Hh, Mm, Gg^Efm, Gs^Fp, Gs^Fp, Hh, Gg, Ds, Ds, Ww, Ww, Ww, Ww, Wwr, Wo, Wo, Wo, Wo, Wo
Wo, Wo, Wwr, Ww, Ww, Ww, Ds, Gs^Fp, Gs^Fp, Gg^Efm, Gg^Efm, Gs^Fp, Gg^Efm, Gs^Fp, Gg^Efm, Gs^Fp, Gg^Efm, Cv, Gg^Efm, Gg^Efm, Gs^Fp, Gs^Fp, Gs^Fp, Gs^Fp, Gg^Efm, Gs^Fp, Gs^Fp, Gg^Efm, Gs^Fp, Gs^Fp, Gg^Efm, Hh, Gs^Fp, Gs^Fp, Gs^Fp, Gs^Vo, Gg, Ds, Ds, Ds, Ww, Ww, Wwr, Ww, Wo, Wo, Wo, Wo, Wo
Wo, Wo, Wwr, Ww, Ww, Ds, Ds, Gg, Gs^Fp, Gs^Fp, Gs^Ve, Gs^Fp, Gs^Fp, Gs^Fp, Gs^Fp, Gg^Efm, Cv, Kv, Cv, Cv, Gg^Efm, Gg^Efm, Gg, Gg, Ds, Gs^Fp, Gg, Gs^Fp, Gs^Fp, Gs^Fp, Gs^Vo, Gs^Fp, Gs^Fp, Gs^Fp, Ds, Gg, Ds, Wwf, Ww, Ww, Ww, Wwr, Ww, Wo, Wo, Wo, Wo, Wo, Wo
Wo, Wo, Ww, Wwr, Ww, Ww, Ds, Ds, Ds, Gg, Ds, Gs^Fp, Gg, Gs^Fp, Gs^Fp, Gg, Gg^Efm, Gg^Efm, Cv, Gg^Efm, Ds, Ds, Ds, Wwf, Ww, Ds, Ds, Ds, Gs^Fp, Gg, Gs^Fp, Gg, Gg, Ds, Ww, Ds, Ds, Ds, Ww, Ww, Wwr, Wwr, Wo, Wo, Wo, Wo, Wo, Wo, Wo
Wo, Wo, Wo, Ww, Ww, Ww, Ww, Ww, Ds, Wwf, Ww, Ds, Ds, Ds, Ds, Gg, Ds, Gg, Wwf, Gg, Ds, Ds, Ww, Ww, Ww, Ds, Ww, Ds, Ds, Ds, Ds, Ds, Wwf, Ds, Ww, Ww, Ds, Ww, Ww, Ww, Ww, Wo, Wo, Wo, Wo, Wo, Wo, Wo, Wo
Wo, Wo, Wo, Ww, Wwr, Ww, Ww, Ww, Ww, Ww, Ds, Ds, Ds, Ww, Ds, Ds, Ds, Ds, Ww, Ds, Ww, Ds, Ww, Ww, Ww, Ww, Ww, Ds, Ww, Ww, Ds, Ww, Ww, Ww, Ww, Ww, Ww, Ww, Wwr, Wwr, Wo, Wo, Wo, Wo, Wo, Wo, Wo, Wo, Wo
Wo, Wo, Wo, Wo, Wo, Wwr, Wwr, Ww, Ww, Ww, Ww, Ww, Ww, Ww, Ww, Ww, Ww, Ww, Ww, Ww, Ww, Ww, Ww, Ww, Wwr, Ww, Ww, Ww, Ww, Ww, Ww, Ww, Wwr, Ww, Wwr, Ww, Wwr, Wwr, Ww, Ww, Wo, Wo, Wo, Wo, Wo, Wo, Wo, Wo, Wo
Wo, Wo, Wo, Wo, Wo, Ww, Wo, Wwr, Ww, Ww, Wwr, Ww, Wwr, Ww, Wwr, Ww, Wwr, Ww, Wwr, Ww, Wwr, Ww, Wwr, Wwr, Ww, Wwr, Ww, Ww, Wwr, Ww, Wwr, Wwr, Ww, Ww, Wo, Ww, Wo, Wo, Wo, Wo, Wo, Wo, Wo, Wo, Wo, Wo, Wo, Wo, Wo
Wo, Wo, Wo, Wo, Wo, Wo, Wo, Wo, Wo, Ww, Wo, Wwr, Wo, Ww, Wo, Wwr, Wo, Ww, Wo, Ww, Wo, Ww, Wo, Wo, Wo, Wo, Wo, Ww, Wo, Wwr, Wo, Ww, Wo, Wo, Wo, Wo, Wo, Wo, Wo, Wo, Wo, Wo, Wo, Wo, Wo, Wo, Wo, Wo, Wo
