Ms, Ms, Ms, Ms, Ms, Ms, Ms, Ms, Ms, Ha, Ms, Ha, Ms, Ha, Ms, Ms, Ms, Ha, Ha, Ms, Ms, Ms, Ms, Ha, Ha, Ha, Ha, Ms, Ha, Ha, Aa, Aa^Fpa, Aa^Fpa, Aa^Fpa, Aa, Aa, Ai, Wo, Wo
Ha, Ms, Ms, Ms, Ms, Ms, Ms, Ms, Ms, Ms, Ha, Ha, Ha, Ha, Ha, Ms, Ha, Ha, Ha, Ha, Ha, Ms, Ha, Ha, Ai, Ha, Aa^Fpa, Ms, Ha, Aa, Aa^Fpa, Aa^Fpa, Aa^Fpa, Aa^Fpa, Aa, Ai, Ww, Wo, Wo
Ms, Ms, Ms, Ms, Ms, Ms, Ms, Ms, Ms, Ha, Ha, Ha, Ai, Aa, Ha, Ms, Ms, Ha, Ai, Ai, Aa, Ms, Ha, Aa, Ai, Aa, Aa, Aa, Aa, Aa, Re, Aa^Vha, Aa, Re, Ai, Ai, Wo, Ai, Wo
Ms, Ms, Ha, Ha, Ha, Ha, Ms, Ms, Ha, Ha, Ha, Ai, Ai, Aa, Aa, Ha, Ms, Ha, Aa, Ai, Aa, Ha, Ha, Aa, Aa, Ai, Aa, Ai, Ai^Bw/, Aa, Ai, Aa, Ai, Aa, Ai, Ww, Wo, Wo, Wo
Ms, Ms, Ha, Ha, Ai, Ha, Ms, Ms, Ms, Ha, Aa, Aa^Vha, Aa^Fpa, Ai, Ai, Aa^Fpa, Ha, Ms, Ha, Aa^Fpa, Ai, Aa^Fpa, Aa^Fpa, Ha, Aa, Aa, Re, Aa, Aa, Ww, Ai, Ai, Ww, Ai, Ww, Ai, Wo, Wo, Wo
Ms, Ha, Ha, Ai, Aa, Aa, Ha, Ms, Ha, Ha, Ha, Aa, Ha, Aa^Fpa, Ai, Aa, Aa^Fpa, Ha, Ha, Aa, Ai, Aa^Fpa, Aa^Fpa, Aa, Aa, Aa, Re, Aa, Aa^Fpa, Aa, Ai, Ww, Ww, Wo, Ai, Wo, Wo, Wo, Wo
Ha, Ha, Aa, Aa, Aa^Fpa, Aa^Vha, Aa, Aa, Ms, Ha, Cha, Ha, Cha, Rr, Aa, Ai, Ai, Aa, Aa, Aa, Aa, Aa, Re, Aa, Aa^Fpa, Re, Aa, Aa, Aa^Vha, Aa, Aa, Ai, Ww, Ai, Wo, Wo, Wo, Wo, Wo
Ha, Aa, Aa, Ai, Ai, Aa^Fpa, Aa, Ha, Ha, Ha, Cha, Kha, Ha, Rr, Rr, Ai, Ai^Bsb/, Cha, Aa, Ai, Aa^Fpa, Re, Aa^Fpa, Aa^Fpa, Aa^Fpa, Aa, Ha, Ha, Aa^Fpa, Aa, Aa, Ai, Ai, Wo, Ai, Wo, Wo, Wo, Wo
Ms, Ha, Aa, Aa^Fpa, Ai, Aa, Re, Aa, Ha, Rr, Rr, Cha, Ha, Ha, Ha, Cha, Aa, Ai, Ai, Aa, Ha, Aa, Ha, Aa^Vha, Re, Aa, Ha, Ha, Aa^Fpa, Aa^Fpa, Aa, Aa, Ai, Wo, Wo, Wo, Wo, Wo, Wo
Ha, Ms, Ha, Aa^Fpa, Aa^Fpa, Aa, Aa, Aa, Aa^Vha, Aa, Rr, Rr, Aa^Fpa, Aa^Fpa, Aa^Fpa, Aa, Aa, Ai, Ai, Aa, Ha, Ha, Aa, Aa, Aa, Aa, Aa, Ha, Ha, Aa^Fpa, Aa, Ai, Ww, Ai, Wo, Wo, Wo, Wo, Wo
Ha, Ha, Ha, Aa, Aa, Ai, Aa, Aa, Aa, Rr, Aa, Aa, Ha^Fpa, Aa^Fpa, Aa^Fpa, Aa, Re, Ai, Ai, Aa, Aa, Aa, Re, Aa, Aa^Fpa, Re, Re, Aa, Aa^Fpa, Aa^Fpa, Aa, Ai, Ww, Wo, Wo, Ai, Ai, Wo, Wo
Ha, Aa, Aa^Fpa, Aa^Fpa, Aa, Ai^Bw/, Aa, Aa^Fpa, Re, Aa, Ha, Ha, Ha, Ha, Aa, Aa, Re, Ai, Ai, Aa^Fpa, Aa^Fpa, Aa, Ha, Aa^Fpa, Aa^Fpa, Aa, Aa, Aa, Re, Aa, Aa, Ai, Ai, Ww, Ai, Wo, Ww, Wo, Wo
Ha, Aa^Fpa, Aa^Fpa, Aa^Fpa, Ai, Ai, Aa, Aa^Fpa, Re, Aa, Aa, Aa, Aa, Aa, Re, Aa, Aa, Ai, Ai, Aa^Fpa, Aa, Aa, Aa^Vha, Aa^Fpa, Ha, Aa^Fpa, Aa, Aa, Re, Re, Aa^Fpa, Aa^Vha, Aa, Ai, Aa, Ai, Ai, Ai, Wo
Aa, Aa^Fpa, Aa, Aa^Vha, Ai, Ai, Aa, Aa, Aa, Aa, Re, Re, Aa^Fpa, Aa^Fpa, Aa, Aa, Ww, Ai, Aa, Aa, Aa, Aa, Ha, Ha, Aa, Aa, Re, Aa, Aa, Aa, Aa^Fpa, Aa^Fpa, Aa^Fpa, Aa, Aa, Ai, Ai, Ww, Wo
Aa^Fpa, Aa^Fpa, Aa, Ai, Ai, Aa, Aa^Fpa, Aa, Aa, Aa, Aa, Aa^Fpa, Aa^Fpa, Aa, Aa, Cha, Ai^Bsb\, Ai, Aa, Re, Aa, Aa, Re, Aa, Aa, Re, Re, Aa^Fpa, Ha, Ha, Aa^Fpa, Ha, Aa^Fpa, Aa, Aa, Ai, Ww, Ai, Wo
Aa, Aa, Ai, Ww, Ai, Aa, Aa^Fpa, Re, Aa, Aa^Fpa, Ha, Ha, Aa^Fpa, Aa^Fpa, Aa^Fpa, Aa, Ai, Cha, Aa, Re, Aa^Fpa, Aa^Fpa, Aa^Fpa, Aa^Fpa, Aa^Fpa, Aa, Aa^Vha, Ha, Aa, Ha, Ha, Ha, Aa, Aa, Ai, Ai, Ai, Wo, Wo
Ai, Ai, Ww, Ai, Ai, Aa^Fpa, Aa^Fpa, Re, Aa, Ha, Aa^Fpa, Ha, Aa, Aa^Fpa, Aa, Ai, Ww, Aa, Aa, Aa, Aa, Aa, Aa, Aa^Fpa, Aa, Aa, Aa, Aa, Re, Aa, Ce, Aa, Aa, Ai, Ww, Ai, Wo, Wo, Wo
Ai, Ww, Ai, Ww, Ai, Aa^Fpa, Aa^Fpa, Aa^Vha, Aa, Aa^Fpa, Aa^Fpa, Aa^Fpa, Ai, Ai, Ai, Ai, Ai, Ai, Ai, Aa, Aa, Aa^Vha, Aa, Aa, Ai, Aa, Aa, Aa, Aa, Ce, Ke, Ce, Ww, Ai, Wo, Wo, Ai, Wo, Wo
Wo, Wo, Ww, Ai, Ai, Aa, Aa, Aa, Aa, Aa^Fpa, Ai, Ai, Ai, Ai, Wo, Ww, Ai, Ww, Ai, Aa, Ai, Aa, Aa, Ai, Ww, Ai, Ai, Aa, Ai, Ce, Ww, Ww^Bw\, Wo, Wo, Wo, Ai, Wo, Wo, Wo
Wo, Ai, Ai, Ai, Ai, Ai, Ai, Ai, Ai, Ai, Ww, Ww, Wo, Ai, Wo, Ai, Wo, Wo, Ww, Ai, Ai, Ai, Ai, Ai, Ww, Ww, Ai, Ai, Ww, Ai, Wo, Wo, Wo, Wo, Wo, Wo, Wo, Wo, Wo
Wo, Wo, Wo, Wo, Ai, Ww, Ai, Ai, Ai, Ai, Wo, Ai, Wo, Wo, Wo, Wo, Wo, Ai, Wo, Ai, Ww, Ai, Ai, Ww, Ai, Wo, Wo, Ai, Wo, Wo, Wo, Ai, Ai, Wo, Wo, Wo, Wo, Wo, Wo
Wo, Wo, Wo, Wo, Wo, Wo, Wo, Wo, Wo, Wo, Wo, Wo, Wo, Wo, Wo, Wo, Wo, Wo, Wo, Wo, Wo, Ai, Wo, Wo, Wo, Wo, Wo, Wo, Wo, Ai, Wo, Wo, Wo, Wo, Wo, Wo, Wo, Wo, Wo
Wo, Wo, Wo, Wo, Wo, Wo, Wo, Wo, Wo, Wo, Wo, Wo, Wo, Wo, Wo, Wo, Wo, Wo, Wo, Wo, Wo, Wo, Wo, Wo, Wo, Wo, Wo, Wo, Wo, Wo, Wo, Wo, Wo, Wo, Wo, Wo, Wo, Wo, Wo
