Wo, Wo, Wo, Wo, Wo, Wo, Wo, Wo, Wo, Wo, Wo, Wo, Wo, Wo, Wo, Wo, Wo, Wo, Wo, Wo, Wo, Wo
Wo, Wo, Wo, Wo, Ww, Wo, Ww, Wo, Ww, Wo, Ww, Wo, Ww, Wo, Wo, Wo, Wo, Wo, Wo, Wo, Wo, Wo
Wo, Wo, Ww, Ww, Dd, Ww, Dd, Dd, Dd, Ww, Dd, Ww, Dd, Ww, Ww, Wo, Wo, Wo, Wo, Wo, Wo, Wo
Wo, Wo, Ww, Dd, Gs^Ft, Gs, Gs^Ft, Dd, Gs, Dd, Dd, Dd, Gs^Ft, Dd, Dd, Ww, Wo, Wo, Wo, Wo, Wo, Wo
Wo, Wo, Ww, Dd, Gs^Ft, Gs^Ft, Gs, Gs, Rb^Gvs, Gs, Gs, Gs^Vh, Hh, Dd, Dd, Ww, Ww, Ww, Ww, Wo, Wo, Wo
Wo, Wo, Wo, Ww, Gs, Gs^Ft, Ke, Rb^Gvs, Rb^Gvs, Rb^Gvs, Gs, Gs^Ft, Gs^Ft, Hh, Gs^Ft, Gs, Dd, Dd, Dd, Ww, Wo, Wo
Wo, Wo, Ww, Ww, Dd, Ce, Ce, Ce, Gs^Ft, Gs^Ft, Gs, Hh, Gs^Ft, Gs^Ft, Hh, Gs^Ft, Gs^Ft, Dd, Dd, Ww, Ww, Wo
Wo, Ww, Dd, Ww, Dd, Gs, Gs, Gs, Rb^Gvs, Rb^Gvs, Rb^Gvs, Gs, Gs^Vh, Gs, Hh, Gs^Ft, Gs^Ft, Gs, Dd, Dd, Ww, Wo
Wo, Ww, Dd, Dd, Gs, Gs^Ft, Gs^Ft, Hh, Gs^Ft, Rb^Gvs, Gs^Ft, Gs, Rb^Gvs, Gs, Hh, Hh, Gs, Dd, Dd, Ww, Wo, Wo
Wo, Ww, Ww, Dd, Gs, Gs, Gs, Gs^Ft, Gs^Vh, Gs, Gs, Rb^Gvs, Rb^Gvs, Rb^Gvs, Gs^Ft, Gs^Vh, Dd, Ww, Ww, Ww, Wo, Wo
Wo, Wo, Ww, Dd, Gs, Gs^Ft, Gs^Ft, Hh, Hh, Gs, Gs^Ft, Gs, Hh, Gs, Gs^Ft, Gs, Dd, Ww, Ww, Wo, Wo, Wo
Ww, Ww, Dd, Dd, Gs^Ft, Gs^Ft, Hh, Gs, Gs, Gs, Gs^Ft, Hh, Hh, Gs, Gs^Ft, Gs^Ft, Gs, Ww, Dd, Ww, Wo, Wo
Dd, Ww, Dd, Dd, Gs^Ft, Hh, Gs^Ft, Gs, Gs, Hh, Gs^Vh, Gs^Ft, Gs, Gs, Rb^Gvs, Gs, Gs^Ft, Dd, Ww, Ww, Wo, Wo
Gs, Gs, Hh, Gs^Ft, Hh, Gs^Ft, Rb^Gvs, Rb^Gvs, Rb^Gvs, Gs, Gs, Gs, Gs, Rb^Gvs, Rb^Gvs, Rb^Gvs, Gs^Vh, Dd, Dd, Ww, Ww, Wo
Gs, Hh, Gs, Hh, Re, Gs, Gs, Rb^Gvs, Gs^Ft, Gs^Ft, Hh, Gs, Rb^Gvs, Gs^Ft, Gs^Ft, Gs, Hh, Gs, Dd, Ww, Ww, Wo
Re, Re, Re, Re, Gs, Re, Re, Gs, Hh, Hh, Gs^Ft, Rb^Gvs, Rb^Gvs, Rb^Gvs, Gs, Gs, Gs^Ft, Hh, Dd, Dd, Ww, Wo
Gs, Gs^Vh, Gs^Ft, Gs^Ft, Hh, Hh, Gs^Vh, Re, Re, Gs^Ft, Hh, Gs^Ft, Gs, Gs, Hh, Gs, Hh, Gs^Ft, Gs, Ww, Dd, Wo
Hh, Hh, Gs^Ft, Gs^Ft, Gs^Ft, Hh, Gs, Gs^Ft, Re, Gs^Ft, Gs, Ce, Gs, Gs^Vh, Gs^Ft, Hh, Gs^Ft, Hh, Gs^Ft, Dd, Dd, Ww
Gs^Ft, Gs^Ft, Dd, Dd, Dd, Hh, Hh, Hh, Gs, Re, Ce, Ce, Ket, Gs, Hh, Gs^Ft, Hh, Hh, Gs^Ft, Gs, Dd, Dd
Dd, Gs^Ft, Dd, Ww, Ww, Dd, Hh, Hh, Gs^Ft, Gs, Gs, Re, Ce, Ce, Re, Gs, Re, Gs^Vh, Re, Gs^Ft, Gs^Ft, Gs^Ft
Ww, Dd, Ww, Ww, Ww, Dd, Dd, Gs^Ft, Hh, Gs^Ft, Hh, Gs, Gs, Re, Gs, Re, Gs^Ft, Re, Gs, Re, Gs, Gs
Ww, Ww, Wo, Wo, Wo, Ww, Dd, Gs^Ft, Gs^Ft, Hh, Gs^Ft, Gs^Ft, Gs^Ft, Re, Gs^Ft, Gs^Ft, Gs^Ft, Gs^Ft, Gs^Ft, Re, Re, Gs
