Wo, Wo, Wo, Wo, Wo, Wo, Wo, Wo, Wo, Wo, Wo, Ww, Ww, Dd, Gs^Ft, Hh, Hh, Gs^Ft, Gs^Ft, Re, Gs^Ft, Hh, Gs^Ft, Dd, Dd, Ww, Wo, Wo, Wo, Wo, Wo, Wo, Wo
Wo, Wo, Wo, Wo, Wo, Wo, Ww, Wo, Ww, Ww, Ww, Ww, Ww, Dd, Dd, Hh, Hh, Gs^Ft, Re, Re, Gs^Ft, Hh, Gs^Ft, Dd, Ww, Ww, Wo, Wo, Wo, Wo, Wo, Wo, Wo
Wo, Wo, Wo, Wo, Ww, Ww, Dd, Ww, Dd, Dd, Ww, Ww, Ww, Ww, Dd, Gs^Ft, Gs^Ft, Gs^Ft, Re, Gs^Ft, Hh, Gs^Ft, Gs^Ft, Dd, Ww, Wo, Wo, Wo, Wo, Wo, Wo, Wo, Wo
Wo, Wo, Ww, Ww, Dd, Ww, Dd, Ww, Dd, Dd, Dd, Dd, Ww, Ww, Ww, Dd, Hh, Gs^Ft, Re, Gs, Gs^Ft, Gs^Ft, Dd, Dd, Ww, Wo, Wo, Wo, Wo, Wo, Wo, Wo, Wo
Wo, Wo, Ww, Dd, Dd, Dd, Gs^Ft, Dd, Hh, Hh, Gs^Ft, Dd, Dd, Ww, Dd, Dd, Gs, Re, Gs, Gs^Vh, Hh, Gs^Ft, Dd, Ww, Wo, Wo, Wo, Wo, Ww, Ww, Ww, Wo, Wo
Wo, Wo, Ww, Ww, Dd, Gs^Ft, Gs^Ft, Gs^Ft, Rb^Gvs, Gs^Vh, Gs^Ft, Gs^Ft, Gs, Dd, Gs^Ft, Gs^Ft, Re, Re, Ce, Gs, Hh, Hh, Dd, Ww, Wo, Wo, Ww, Ww, Gs, Dd, Gs, Ww, Ww
Wo, Wo, Ww, Dd, Ww, Dd, Gs^Ft, Rb^Gvs, Rb^Gvs, Rb^Gvs, Gs, Gs^Ft, Rb^Gvs, Gs, Gs, Ce, Ce, Ket, Re, Hh, Dd, Dd, Ww, Ww, Wo, Wo, Ww, Dd, Gs^Ft, Hh, Gs^Ft, Dd, Ww
Wo, Wo, Wo, Ww, Dd, Dd, Hh, Gs, Hh, Gs, Gs, Rb^Gvs, Rb^Gvs, Rb^Gvs, Re, Re, Gs, Ce, Gs, Gs^Vh, Dd, Ww, Ww, Wo, Wo, Wo, Ww, Dd, Hh, Hh, Dd, Ww, Wo
Wo, Wo, Wo, Ww, Dd, Dd, Dd, Hh, Rb^Gvs, Rb^Gvs, Rb^Gvs, Gs^Ft, Gs^Ft, Gs^Vh, Re, Gs, Hh, Gs, Rb^Gvs, Gs, Dd, Ww, Dd, Ww, Ww, Wo, Wo, Ww, Dd, Gs^Vh, Dd, Ww, Wo
Wo, Wo, Wo, Ww, Ww, Ww, Dd, Gs, Gs, Rb^Gvs, Gs^Ft, Gs^Ft, Gs, Re, Gs, Hh, Gs, Rb^Gvs, Rb^Gvs, Rb^Gvs, Gs, Dd, Dd, Dd, Ww, Wo, Wo, Ww, Ww, Dd, Ww, Ww, Wo
Wo, Wo, Wo, Wo, Ww, Ww, Dd, Gs^Vh, Gs, Gs, Rb^Gvs, Gs^Ft, Re, Re, Gs^Ft, Hh, Gs^Ft, Gs, Gs, Gs, Rb^Gvs, Gs^Ft, Dd, Ww, Ww, Wo, Wo, Wo, Wo, Ww, Dd, Ww, Wo
Wo, Wo, Ww, Ww, Ww, Dd, Gs^Ft, Hh, Hh, Rb^Gvs, Rb^Gvs, Rb^Gvs, Gs, Hh, Hh, Gs^Ft, Gs^Ft, Gs, Gs^Vh, Rb^Gvs, Rb^Gvs, Rb^Gvs, Gs^Vh, Dd, Ww, Wo, Wo, Wo, Wo, Ww, Dd, Ww, Wo
Wo, Wo, Ww, Dd, Dd, Dd, Gs^Ft, Gs^Ft, Gs, Gs, Gs, Gs, Gs^Ft, Hh, Hh, Gs^Ft, Gs, Gs, Dd, Gs, Gs^Ft, Gs, Gs^Ft, Dd, Dd, Ww, Wo, Wo, Wo, Ww, Ww, Ww, Wo
Wo, Wo, Ww, Dd, Dd, Gs^Ft, Gs^Ft, Hh, Rb^Gvs, Rb^Gvs, Rb^Gvs, Re, Gs^Ft, Gs^Ft, Hh, Gs, Dd, Dd, Ww, Dd, Dd, Gs^Ft, Dd, Dd, Dd, Ww, Wo, Wo, Wo, Wo, Wo, Wo, Wo
Wo, Wo, Wo, Ww, Dd, Gs^Ft, Dd, Gs, Gs, Rb^Gvs, Gs, Re, Gs, Hh, Gs^Ft, Hh, Dd, Ww, Ww, Ww, Dd, Dd, Ww, Ww, Ww, Ww, Wo, Wo, Wo, Wo, Ww, Wo, Wo
Wo, Wo, Wo, Ww, Ww, Dd, Ww, Dd, Hh, Gs^Vh, Hh, Re, Re, Hh, Re, Gs^Ft, Gs, Dd, Ww, Ww, Ww, Dd, Ww, Ww, Ww, Wo, Ww, Ww, Ww, Ww, Dd, Ww, Ww
Wo, Wo, Wo, Wo, Wo, Ww, Ww, Dd, Dd, Hh, Hh, Gs, Gs, Gs, Gs, Re, Ce, Dd, Dd, Dd, Dd, Ww, Ww, Wo, Ww, Ww, Dd, Ww, Dd, Ww, Dd, Dd, Ww
Wo, Wo, Wo, Wo, Wo, Wo, Ww, Ww, Dd, Gs^Ft, Hh, Gs^Ft, Rb^Gvs, Rb^Gvs, Rb^Gvs, Ce, Ket, Gs, Gs, Gs, Dd, Ww, Ww, Wo, Ww, Dd, Dd, Dd, Gs, Dd, Gs^Ft, Dd, Dd
Wo, Wo, Wo, Wo, Ww, Ww, Dd, Ww, Dd, Gs^Ft, Gs^Ft, Gs^Ft, Gs, Rb^Gvs, Gs^Ft, Re, Gs, Ce, Gs, Hh, Gs^Vh, Dd, Ww, Ww, Ww, Dd, Gs^Ft, Gs, Gs^Vh, Hh, Hh, Hh, Hh
Wo, Wo, Wo, Wo, Ww, Dd, Dd, Dd, Gs^Vh, Gs, Rb^Gvs, Gs^Ft, Gs, Gs, Hh, Re, Dd, Dd, Dd, Gs, Dd, Dd, Ww, Ww, Dd, Dd, Gs^Ft, Gs^Ft, Gs, Gs, Ce, Gs, Gs
Wo, Wo, Wo, Wo, Ww, Dd, Dd, Gs, Gs, Rb^Gvs, Rb^Gvs, Rb^Gvs, Gs, Hh, Gs^Ft, Re, Dd, Ww, Ww, Ww, Ww, Ww, Ww, Ww, Dd, Dd, Gs^Ft, Gs, Ce, Ke, Ce, Re, Re
Wo, Wo, Wo, Wo, Wo, Ww, Dd, Gs, Hh, Gs, Gs^Ft, Gs, Gs, Gs^Ft, Re, Gs, Dd, Ww, Ww, Ww, Ww, Ww, Ww, Dd, Dd, Gs, Gs, Re, Gs, Gs, Gs, Gs, Gs
Wo, Wo, Wo, Wo, Ww, Ww, Dd, Hh, Gs^Ft, Gs^Ft, Gs^Ft, Gs^Ft, Gs^Vh, Gs, Re, Gs, Gs, Dd, Dd, Dd, Ww, Ww, Dd, Dd, Gs, Gs, Hh, Gs^Vh, Hh, Hh, Gs, Gs^Ft, Gs^Ft
Wo, Wo, Wo, Wo, Ww, Dd, Dd, Dd, Dd, Dd, Dd, Gs^Ft, Gs^Ft, Hh, Hh, Re, Gs^Ft, Gs^Ft, Gs^Ft, Dd, Dd, Ww, Dd, Gs^Ft, Re, Re, Gs^Ft, Hh, Dd, Dd, Dd, Dd, Dd
Wo, Wo, Wo, Wo, Wo, Ww, Ww, Ww, Ww, Ww, Dd, Dd, Dd, Dd, Dd, Re, Gs, Hh, Hh, Hh, Hh, Dd, Gs^Ft, Gs^Ft, Re, Gs, Dd, Dd, Ww, Ww, Ww, Ww, Ww
Wo, Wo, Wo, Wo, Wo, Wo, Wo, Wo, Wo, Ww, Ww, Ww, Ww, Ww, Ww, Dd, Gs, Re, Re, Gs, Re, Re, Gs, Re, Gs, Gs, Dd, Dd, Ww, Wo, Wo, Wo, Wo
Wo, Wo, Wo, Wo, Wo, Wo, Wo, Wo, Wo, Wo, Wo, Wo, Wo, Ww, Dd, Dd, Dd, Gs, Gs^Vh, Gs, Gs^Ft, Gs^Ft, Dd, Hh, Dd, Dd, Ww, Ww, Wo, Wo, Wo, Wo, Wo
Wo, Wo, Wo, Wo, Wo, Wo, Wo, Wo, Wo, Wo, Wo, Wo, Wo, Ww, Ww, Dd, Ww, Dd, Dd, Dd, Dd, Dd, Ww, Dd, Ww, Dd, Ww, Wo, Wo, Wo, Wo, Wo, Wo
Wo, Wo, Wo, Wo, Wo, Wo, Wo, Wo, Wo, Wo, Wo, Wo, Wo, Wo, Wo, Ww, Wo, Ww, Dd, Dd, Ww, Dd, Ww, Ww, Wo, Ww, Wo, Wo, Wo, Wo, Wo, Wo, Wo
Wo, Wo, Wo, Wo, Wo, Wo, Wo, Wo, Wo, Wo, Wo, Wo, Wo, Wo, Wo, Wo, Wo, Ww, Ww, Ww, Wo, Ww, Wo, Wo, Wo, Wo, Wo, Wo, Wo, Wo, Wo, Wo, Wo
Wo, Wo, Wo, Wo, Wo, Wo, Wo, Wo, Wo, Wo, Wo, Wo, Wo, Wo, Wo, Wo, Wo, Wo, Wo, Wo, Wo, Wo, Wo, Wo, Wo, Wo, Wo, Wo, Wo, Wo, Wo, Wo, Wo
