Wo, Wo, Wo, Wo, Wo, Wo, Wo, Wo, Wo, Wo, Wo, Wo, Wo, Wo, Wo, Wo, Wo, Wo, Wo, Wo, Wo, Wo, Wo
Wo, Wo, Wo, Wo, Wo, Wo, Wo, Wo, Wo, Wo, Wo, Wo, Ww, Wo, Ww, Wo, Ww, Wo, Wo, Wo, Wo, Wo, Wo
Wo, Wo, Wo, Wo, Ww, Wo, Ww, Ww, Ww, Ww, Ww, Ww, Ww, Ww, Ww, Ww, Ww, Ww, Ww, Wo, Wo, Wo, Wo
Wo, Wo, Ww, Ww, Dd, Ww, Dd, Dd, Dd, Dd, Dd, Ww, Dd, Ww, Ww^Bw|, Ww, Dd, Dd, Dd, Ww, Ww, Wo, Wo
Wo, Wo, Ww, Dd, Dd, Dd, Gs^Ft, Gs, Rb^Gvs, Gs^Vh, Gs^Ft, Dd, Ce, Dd, Ww^Bw/, Ww, Dd, Dd, Dd, Dd, Ww, Wo, Wo
Wo, Ww, Dd, Dd, Gs, Gs^Ft, Hh, Rb^Gvs, Rb^Gvs, Rb^Gvs, Gs, Ce, Ket, Re, Re, Dd, Gs^Ft, Gs^Ft, Dd, Ww, Ww, Wo, Wo
Wo, Ww, Ww, Dd, Dd, Gs^Ft, Hh, Gs, Gs^Ft, Gs, Re, Re, Ce, Ce, Ce, Gs, Gs^Vh, Dd, Ww, Ww, Wo, Wo, Wo
Wo, Wo, Ww, Dd, Dd, Gs, Gs^Ft, Hh, Gs^Ft, Gs^Ft, Re, Ce, Gs, Re, Gs, Gs, Gs^Ft, Dd, Dd, Ww, Wo, Wo, Wo
Wo, Wo, Wo, Ww, Dd, Dd, Rb^Gvs, Rb^Gvs, Rb^Gvs, Gs, Re, Gs, Rb^Gvs, Gs, Gs^Ft, Hh, Gs^Ft, Gs^Ft, Dd, Ww, Wo, Wo, Wo
Wo, Wo, Ww, Ww, Dd, Dd, Gs^Ft, Rb^Gvs, Gs, Re, Gs, Rb^Gvs, Rb^Gvs, Rb^Gvs, Hh, Gs, Gs, Dd, Dd, Ww, Wo, Wo, Wo
Wo, Wo, Ww, Dd, Dd, Gs^Ft, Rb^Gvs, Gs^Vh, Re, Re, Hh, Gs^Ft, Gs^Ft, Gs, Gs, Gs^Vh, Dd, Dd, Ww, Ww, Wo, Wo, Wo
Wo, Ww, Dd, Dd, Gs, Rb^Gvs, Rb^Gvs, Rb^Gvs, Re, Gs^Ft, Hh, Hh, Hh, Hh, Gs^Ft, Gs, Dd, Dd, Ww, Wo, Wo, Wo, Wo
Wo, Ww, Ww, Dd, Gs^Ft, Gs^Ft, Gs^Ft, Gs, Re, Hh, Gs, Gs^Vh, Gs, Hh, Hh, Dd, Dd, Ww, Ww, Wo, Wo, Wo, Wo
Wo, Wo, Ww, Gs, Gs^Vh, Hh, Hh, Gs, Re, Gs, Rb^Gvs, Rb^Gvs, Rb^Gvs, Gs^Ft, Gs^Ft, Gs^Ft, Dd, Dd, Ww, Wo, Wo, Wo, Wo
Wo, Ww, Dd, Dd, Gs^Ft, Gs^Ft, Gs^Ft, Gs^Ft, Gs^Ft, Re, Gs, Rb^Gvs, Gs^Ft, Gs, Gs, Dd, Dd, Ww, Wo, Wo, Wo, Wo, Wo
Wo, Ww, Dd, Dd, Dd, Gs, Rb^Gvs, Rb^Gvs, Rb^Gvs, Re, Re, Gs^Ft, Rb^Gvs, Rb^Gvs, Rb^Gvs, Dd, Dd, Ww, Ww, Wo, Wo, Wo, Wo
Wo, Ww, Ww, Dd, Ww, Gs, Gs^Ft, Rb^Gvs, Gs, Gs, Ce, Gs, Gs, Rb^Gvs, Gs, Gs, Dd, Dd, Ww, Wo, Wo, Wo, Wo
Wo, Wo, Wo, Ww, Ww, Dd, Hh, Gs^Ft, Gs, Ce, Ke, Ce, Gs, Gs, Gs, Gs^Ft, Gs^Ft, Dd, Dd, Ww, Wo, Wo, Wo
Wo, Wo, Wo, Ww, Dd, Dd, Gs^Ft, Hh, Gs^Ft, Gs, Re, Gs, Gs^Ft, Hh, Gs^Vh, Gs^Ft, Dd, Dd, Ww, Ww, Wo, Wo, Wo
Wo, Wo, Wo, Ww, Dd, Dd, Gs, Hh, Hh, Gs^Ft, Re, Gs^Ft, Gs^Ft, Gs^Ft, Hh, Gs, Ww, Dd, Ww, Wo, Wo, Wo, Wo
Wo, Wo, Wo, Ww, Ww, Ww, Dd, Gs^Ft, Hh, Hh, Gs^Ft, Re, Gs^Ft, Hh, Gs^Ft, Dd, Ww, Ww, Wo, Wo, Wo, Wo, Wo
Wo, Wo, Wo, Wo, Wo, Ww, Dd, Gs^Ft, Hh, Gs^Ft, Re, Re, Gs^Ft, Hh, Gs^Ft, Dd, Dd, Ww, Wo, Wo, Wo, Wo, Wo
