Wo, Wo, Wo, Wo, Wo, Wo, Wo, Wo, Wo, Wo, Wo, Wo, Wo, Wo, Wo, Wo, Wo, Wo, Wo, Wo, Wo, Wo, Wo, Wo, Wo, Wo, Wo, Wo, Wo, Wo, Wo, Wo
Wo, Wo, Wo, Wo, Wo, Wo, Wo, Wo, Wo, Wo, Wo, Wo, Wo, Wo, Wo, Wo, Wo, Wo, Wo, Wo, Wo, Wo, Wo, Wo, Wo, Wo, Wo, Wo, Wo, Wo, Wo, Wo
Wo, Wo, Wo, Wo, Wo, Wo, Wo, Wo, Wo, Wo, Wo, Wo, Wo, Wo, Ww, Ww, Ww, Ww, Ww, Wo, Wo, Wo, Wo, Wo, Wo, Wo, Wo, Wo, Wo, Wo, Wo, Wo
Wo, Wo, Wo, Wo, Wo, Wo, Wo, Wo, Wo, Wo, Wo, Wo, Ww, Ww, Dd, Dd, Dd, Dd, Dd, Ww, Wo, Wo, Wo, Wo, Wo, Wo, Wo, Wo, Wo, Wo, Wo, Wo
Wo, Wo, Wo, Wo, Wo, Wo, Wo, Wo, Wo, Wo, Ww, Ww, Dd, Dd, Dd, Dd, Dd, Rr^Vd, Dd, Ww, Ww, Wo, Wo, Wo, Wo, Wo, Wo, Wo, Wo, Wo, Wo, Wo
Wo, Wo, Wo, Wo, Wo, Wo, Wo, Wo, Wo, Ww, Dd, Dd, Gs, Dd, Dd, Dd, Ce, Gs, Gs, Dd, Dd, Ww, Ww, Ww, Ww, Wo, Wo, Wo, Wo, Wo, Wo, Wo
Wo, Wo, Wo, Wo, Wo, Wo, Ww, Wo, Ww, Ww, Dd, Rr^Vd, Gs, Gs, Ce, Ke, Ce, Gs, Gs, Dd, Dd, Dd, Dd, Dd, Dd, Ww, Wo, Wo, Wo, Wo, Wo, Wo
Wo, Wo, Wo, Wo, Ww, Ww, Dd, Ww, Dd, Dd, Dd, Gs, Hd, Hd, Hd, Ce, Gs, Hd, Dd, Gs, Gs^Ft, Gs^Ft, Gs^Ft, Gs^Ft, Dd, Ww, Ww, Wo, Wo, Wo, Wo, Wo
Wo, Wo, Wo, Wo, Ww, Dd, Dd, Dd, Gs, Dd, Dd, Dd, Dd, Gs, Dd, Dd, Dd, Hd, Dd, Dd, Gs^Ft, Gs^Ft, Gs^Ft, Gs^Ft, Gs^Ft, Dd, Dd, Ww, Ww, Wo, Wo, Wo
Wo, Wo, Wo, Wo, Dd, Dd, Dd, Hd, Hd, Gs, Dd, Dd, Gs^Ft, Gs^Ft, Gs^Ft, Dd, Gs, Gs, Dd, Dd, Gs^Ft, Gs^Ft, Ww, Ww, Ww, Gs^Ft, Gs^Ft, Dd, Ww, Wo, Wo, Wo
Wo, Wo, Wo, Ww, Dd, Dd, Dd, Hd, Gs, Dd, Dd, Dd, Gs^Ft, Gs^Ft, Ww, Gs^Ft, Gs^Ft, Rr^Vd, Dd, Dd, Gs^Ft, Gs^Ft, Ww, Ww, Ww, Gs^Ft, Gs^Ft, Dd, Dd, Ww, Wo, Wo
Wo, Wo, Ww, Ww, Dd, Gs, Dd, Gs, Gs^Ft, Dd, Dd, Gs^Ft, Gs^Ft, Ww, Ww, Ww, Gs^Ft, Gs^Ft, Dd, Dd, Gs^Ft, Gs^Ft, Ww, Ww, Ww, Gs^Ft, Gs^Ft, Rr^Vd, Dd, Ww, Wo, Wo
Wo, Wo, Ww, Dd, Rr^Vd, Gs, Gs^Ft, Gs^Ft, Gs^Ft, Dd, Gs, Gs^Ft, Gs^Ft, Ww, Ww, Ww, Ww, Gs^Ft, Dd, Gs, Gs^Ft, Gs^Ft, Gs^Ft, Ww, Gs^Ft, Gs^Ft, Gs^Ft, Gs, Dd, Ww, Wo, Wo
Wo, Wo, Ww, Dd, Dd, Gs^Ft, Gs^Ft, Ww, Gs^Ft, Gs^Ft, Dd, Rr^Vd, Gs^Ft, Gs^Ft, Ww, Ww, Ww, Gs^Ft, Dd, Dd, Dd, Gs^Ft, Gs^Ft, Gs^Ft, Gs^Ft, Gs^Ft, Dd, Dd, Ww, Ww, Wo, Wo
Wo, Wo, Wo, Ww, Dd, Gs^Ft, Gs^Ft, Ww, Ww, Gs^Ft, Gs^Ft, Dd, Dd, Gs^Ft, Gs^Ft, Gs^Ft, Gs^Ft, Gs^Ft, Dd, Dd, Dd, Gs, Dd, Dd, Gs, Dd, Dd, Dd, Ww, Wo, Wo, Wo
Wo, Wo, Wo, Ww, Dd, Gs^Ft, Gs^Ft, Ww, Ww, Gs^Ft, Gs, Gs, Dd, Dd, Dd, Gs^Ft, Dd, Gs, Gs, Dd, Gs, Dd, Dd, Dd, Gs, Gs, Dd, Ww, Wo, Wo, Wo, Wo
Wo, Wo, Ww, Dd, Dd, Dd, Gs^Ft, Gs^Ft, Gs^Ft, Gs^Ft, Dd, Gs, Dd, Dd, Dd, Dd, Md, Hd, Gs, Gs, Dd, Hd, Hd, Dd, Dd, Gs, Dd, Ww, Ww, Wo, Wo, Wo
Wo, Wo, Ww, Dd, Dd, Dd, Dd, Gs^Ft, Hd, Gs, Gs, Dd, Dd, Dd, Dd, Hd, Hd, Hd, Dd, Gs, Rr^Vd, Hd, Dd, Gs, Gs, Gs, Rr^Vd, Dd, Ww, Wo, Wo, Wo
Wo, Wo, Wo, Ww, Dd, Dd, Dd, Hd, Md, Hd, Dd, Dd, Dd, Dd, Dd, Dd, Ce, Ce, Ce, Gs, Gs, Dd, Dd, Dd, Gs, Dd, Dd, Dd, Ww, Wo, Wo, Wo
Wo, Wo, Wo, Ww, Dd, Dd, Dd, Hd, Hd, Rr^Vd, Gs^Ft, Gs^Ft, Gs^Ft, Gs^Ft, Gs^Ft, Dd, Dd, Ke, Dd, Dd, Gs, Dd, Dd, Dd, Dd, Dd, Dd, Ww, Wo, Wo, Wo, Wo
Wo, Wo, Wo, Ww, Ww, Dd, Dd, Hd, Gs, Gs^Ft, Gs^Ft, Ww, Ww, Gs^Ft, Gs^Ft, Dd, Gs, Dd, Dd, Gs, Dd, Dd, Ww, Ww, Ww, Dd, Ww, Ww, Wo, Wo, Wo, Wo
Wo, Wo, Wo, Wo, Wo, Ww, Dd, Dd, Gs, Gs, Gs^Ft, Gs^Ft, Ww, Ww, Ww, Gs^Ft, Gs, Gs, Dd, Dd, Dd, Ww, Wo, Wo, Wo, Ww, Wo, Wo, Wo, Wo, Wo, Wo
Wo, Wo, Wo, Wo, Wo, Ww, Ww, Dd, Dd, Gs, Gs, Gs^Ft, Gs^Ft, Ww, Gs^Ft, Gs^Ft, Dd, Dd, Dd, Dd, Ww, Ww, Wo, Wo, Wo, Wo, Wo, Wo, Wo, Wo, Wo, Wo
Wo, Wo, Wo, Wo, Wo, Wo, Ww, Dd, Dd, Dd, Dd, Rr^Vd, Dd, Gs^Ft, Gs^Ft, Dd, Dd, Dd, Ww, Ww, Wo, Wo, Wo, Wo, Wo, Wo, Wo, Wo, Wo, Wo, Wo, Wo
Wo, Wo, Wo, Wo, Wo, Wo, Wo, Ww, Ww, Dd, Ww, Dd, Ww, Dd, Dd, Dd, Dd, Dd, Ww, Wo, Wo, Wo, Wo, Wo, Wo, Wo, Wo, Wo, Wo, Wo, Wo, Wo
Wo, Wo, Wo, Wo, Wo, Wo, Wo, Wo, Wo, Ww, Wo, Ww, Wo, Ww, Ww, Dd, Ww, Ww, Wo, Wo, Wo, Wo, Wo, Wo, Wo, Wo, Wo, Wo, Wo, Wo, Wo, Wo
Wo, Wo, Wo, Wo, Wo, Wo, Wo, Wo, Wo, Wo, Wo, Wo, Wo, Wo, Wo, Ww, Wo, Wo, Wo, Wo, Wo, Wo, Wo, Wo, Wo, Wo, Wo, Wo, Wo, Wo, Wo, Wo
Wo, Wo, Wo, Wo, Wo, Wo, Wo, Wo, Wo, Wo, Wo, Wo, Wo, Wo, Wo, Wo, Wo, Wo, Wo, Wo, Wo, Wo, Wo, Wo, Wo, Wo, Wo, Wo, Wo, Wo, Wo, Wo
Wo, Wo, Wo, Wo, Wo, Wo, Wo, Wo, Wo, Wo, Wo, Wo, Wo, Wo, Wo, Wo, Wo, Wo, Wo, Wo, Wo, Wo, Wo, Wo, Wo, Wo, Wo, Wo, Wo, Wo, Wo, Wo
