Wo, Wo, Wo, Wo, Wo, Wo, Wo, Wo, Wo, Wo, Wo, Wo, Wo, Wo, Wo, Wo, Wo, Wo, Wo, Wo, Wo, Wo, Wo, Wo, Wo, Wo, Wo, Wo, Wo, Wo, Wo, Wo
Wo, Wo, Wo, Wo, Wo, Wo, Wo, Wo, Wo, Wo, Wo, Wo, Wo, Wo, Ww, Wo, Ww, Ww, Ww, Wo, Wo, Wo, Wo, Wo, Wo, Wo, Wo, Wo, Wo, Wo, Wo, Wo
Wo, Wo, Wo, Wo, Wo, Wo, Wo, Wo, Wo, Wo, Ww, Ww, Ww, Ww, Wwf, Ww, Dd, Dd, Dd, Ww, Wo, Wo, Wo, Wo, Wo, Wo, Wo, Wo, Wo, Wo, Wo, Wo
Wo, Wo, Wo, Wo, Wo, Wo, Wo, Wo, Wo, Ww, Dd, Ww, Wwf, Dd, Dd, Dd, Wwf, Rr^Vd, Dd, Ww, Ww, Wo, Ww, Wo, Ww, Wo, Ww, Wo, Wo, Wo, Wo, Wo
Wo, Wo, Wo, Wo, Wo, Wo, Ww, Wo, Ww, Ww, Dd, Wwf, Dd, Dd, Gs, Gs, Gs, Gs, Gs^Ft, Dd, Wwf, Ww, Ww, Ww, Ww, Ww, Ww, Wo, Wo, Wo, Wo, Wo
Wo, Wo, Wo, Wo, Wo, Ww, Ww, Ww, Ww, Dd, Dd, Dd, Wwf, Dd, Chr, Chr, Gs^Ft, Wwf, Wwf, Dd, Dd, Wwf, Wwf, Dd, Dd, Dd, Ww, Ww, Wo, Wo, Wo, Wo
Wo, Wo, Wo, Wo, Ww, Ww, Dd, Ww, Wwf, Wwf, Dd, Dd, Wwf, Gs, Gs^Ft, Khr, Chr, Gs, Dd, Dd, Rr^Vd, Dd, Dd, Gs^Ft, Dd, Ww, Ww, Ww, Wo, Wo, Wo, Wo
Wo, Wo, Wo, Ww, Ww, Ww, Dd, Wwf, Dd, Dd, Rr^Vd, Wwf, Dd, Gs, Gs^Ft, Chr, Gs^Ft, Gs, Dd, Wwf, Dd, Gs, Hh, Gs^Ft, Gs, Dd, Wwf, Ww, Ww, Wo, Wo, Wo
Wo, Wo, Ww, Ww, Wwf, Dd, Gs^Ft, Dd, Wwf, Dd, Gs, Gs, Hh, Gs^Ft, Gs, Chr, Dd, Dd, Gs^Ft, Wwf, Mm, Hh, Dd, Gs, Gs^Ft, Dd, Dd, Wwf, Dd, Ww, Wo, Wo
Wo, Wo, Ww, Dd, Dd, Gs^Ft, Rr^Vd, Dd, Dd, Wwf, Gs, Mm, Hh, Gs^Ft, Gs, Dd, Wwf, Wwf, Dd, Gs^Ft, Hh, Dd, Wwf, Gs, Gs^Ft, Gs^Ft, Gs, Dd, Wwf, Ww, Ww, Wo
Wo, Wo, Ww, Ww, Dd, Gs^Ft, Dd, Gs, Gs^Ft, Dd, Hh, Hh, Gs^Ft, Gs, Wwf, Dd, Dd, Dd, Wwf, Dd, Dd, Dd, Wwf, Wwf, Gs^Ft, Gs^Ft, Gs^Ft, Dd, Dd, Ww, Ww, Wo
Wo, Ww, Dd, Wwf, Dd, Wwf, Gs, Gs, Gs^Ft, Gs^Ft, Gs, Gs^Ft, Dd, Wwf, Dd, Wwf, Gs^Ft, Dd, Dd, Wwf, Dd, Dd, Wwf, Gs, Gs^Ft, Gs^Ft, Gs, Dd, Dd, Dd, Ww, Wo
Wo, Ww, Ww, Dd, Dd, Wwf, Gs, Gs^Ft, Gs^Ft, Gs, Wwf, Dd, Wwf, Dd, Hh, Gs^Ft, Mm, Hh, Hh, Wwf, Rr^Vd, Wwf, Dd, Gs^Ft, Hh, Gs^Ft, Gs, Wwf, Dd, Wwf, Ww, Wo
Wo, Ww, Dd, Dd, Dd, Dd, Wwf, Gs^Ft, Gs, Wwf, Gs^Ft, Dd, Wwf, Dd, Gs, Hh, Hh, Gs^Ft, Gs^Ft, Gs^Ft, Dd, Dd, Gs^Ft, Hh, Dd, Hh, Rr^Vd, Dd, Wwf, Dd, Ww, Wo
Wo, Ww, Ww, Wwf, Dd, Gs^Ft, Gs^Ft, Wwf, Wwf, Rr^Vd, Gs^Ft, Dd, Gs, Gs, Gs^Ft, Gs, Dd, Dd, Gs, Gs^Ft, Gs, Wwf, Gs, Gs^Ft, Wwf, Gs, Dd, Dd, Ww, Ww, Wo, Wo
Wo, Wo, Ww, Ww, Dd, Gs^Ft, Dd, Wwf, Wwf, Dd, Wwf, Wwf, Gs, Gs^Ft, Gs^Ft, Gs, Gs, Wwf, Wwf, Dd, Wwf, Gs^Ft, Gs^Ft, Gs, Wwf, Gs, Dd, Wwf, Ww, Wo, Wo, Wo
Wo, Wo, Ww, Dd, Gs^Ft, Hh, Hh, Dd, Dd, Dd, Dd, Wwf, Dd, Gs^Ft, Hh, Gs^Ft, Gs^Ft, Dd, Wwf, Wwf, Dd, Gs^Ft, Gs^Ft, Dd, Dd, Wwf, Dd, Wwf, Dd, Ww, Wo, Wo
Wo, Ww, Dd, Dd, Dd, Gs^Ft, Mm, Hh, Dd, Wwf, Wwf, Dd, Hh, Hh, Mm, Hh, Hh, Dd, Dd, Wwf, Wwf, Gs, Gs^Ft, Gs, Wwf, Wwf, Gs^Ft, Gs^Ft, Dd, Ww, Wo, Wo
Wo, Ww, Ww, Wwf, Dd, Gs^Ft, Hh, Hh, Hh, Dd, Gs, Gs, Hh, Hh, Wwf, Dd, Dd, Gs, Dd, Wwf, Gs, Gs^Ft, Gs^Ft, Gs, Wwf, Rr^Vd, Gs^Ft, Dd, Ww, Ww, Wo, Wo
Wo, Ww, Ww, Dd, Dd, Gs^Ft, Gs^Ft, Dd, Gs, Gs^Ft, Gs^Ft, Gs, Gs, Wwf, Dd, Wwf, Dd, Gs, Gs, Wwf, Dd, Gs^Ft, Dd, Dd, Dd, Gs^Ft, Gs^Ft, Wwf, Ww, Wo, Wo, Wo
Wo, Wo, Ww, Dd, Ww, Dd, Dd, Rr^Vd, Wwf, Gs, Gs^Ft, Gs^Ft, Gs, Wwf, Dd, Gs, Gs, Ce, Re, Dd, Wwf, Dd, Wwf, Dd, Wwf, Dd, Dd, Dd, Ww, Wo, Wo, Wo
Wo, Wo, Wo, Ww, Ww, Wwf, Dd, Dd, Wwf, Wwf, Gs, Gs^Ft, Gs, Gs, Wwf, Dd, Re, Ce, Ke, Ce, Dd, Ww, Ww, Ww, Ww, Dd, Ww, Dd, Ww, Wo, Wo, Wo
Wo, Wo, Wo, Ww, Ww, Dd, Wwf, Dd, Dd, Wwf, Wwf, Dd, Gs^Ft, Wwf, Wwf, Dd, Rr^Vd, Re, Gs, Ce, Ww, Ww, Wo, Wo, Wo, Ww, Wo, Ww, Wo, Wo, Wo, Wo
Wo, Wo, Wo, Wo, Ww, Ww, Dd, Dd, Dd, Dd, Dd, Gs^Ft, Dd, Dd, Dd, Gs^Ft, Dd, Dd, Ww, Dd, Ww, Ww, Wo, Wo, Wo, Wo, Wo, Wo, Wo, Wo, Wo, Wo
Wo, Wo, Wo, Wo, Wo, Ww, Dd, Wwf, Ww, Wwf, Dd, Dd, Wwf, Wwf, Dd, Dd, Dd, Ww, Ww, Ww, Ww, Wo, Wo, Wo, Wo, Wo, Wo, Wo, Wo, Wo, Wo, Wo
Wo, Wo, Wo, Wo, Wo, Ww, Ww, Ww, Ww, Ww, Ww, Dd, Ww, Ww, Ww, Ww, Ww, Ww, Wo, Wo, Wo, Wo, Wo, Wo, Wo, Wo, Wo, Wo, Wo, Wo, Wo, Wo
Wo, Wo, Wo, Wo, Wo, Wo, Wo, Wo, Wo, Wo, Ww, Ww, Ww, Ww, Wo, Ww, Wo, Ww, Wo, Wo, Wo, Wo, Wo, Wo, Wo, Wo, Wo, Wo, Wo, Wo, Wo, Wo
Wo, Wo, Wo, Wo, Wo, Wo, Wo, Wo, Wo, Wo, Wo, Wo, Wo, Wo, Wo, Wo, Wo, Wo, Wo, Wo, Wo, Wo, Wo, Wo, Wo, Wo, Wo, Wo, Wo, Wo, Wo, Wo
Wo, Wo, Wo, Wo, Wo, Wo, Wo, Wo, Wo, Wo, Wo, Wo, Wo, Wo, Wo, Wo, Wo, Wo, Wo, Wo, Wo, Wo, Wo, Wo, Wo, Wo, Wo, Wo, Wo, Wo, Wo, Wo
