Wo, Wo, Wo, Wo, Wo, Wo, Wo, Wo, Wo, Wo, Wo, Wo, Wo, Wo, Wo, Wo, Wo, Wo, Wo, Wo, Wo, Wo, Wo, Wo, Wo, Wo, Wo, Wo, Wo, Wo, Wo, Wo
Wo, Wo, Wo, Wo, Wo, Wo, Wo, Wo, Wo, Wo, Wo, Wo, Wo, Wo, Ww, Wo, Ww, Ww, Ww, Wo, Wo, Wo, Wo, Wo, Wo, Wo, Wo, Wo, Wo, Wo, Wo, Wo
Wo, Wo, Wo, Wo, Wo, Wo, Wo, Wo, Wo, Wo, Ww, Ww, Ww, Ww, Wwf, Ww, Dd, Dd, Dd, Ww, Wo, Wo, Wo, Wo, Wo, Wo, Wo, Wo, Wo, Wo, Wo, Wo
Wo, Wo, Wo, Wo, Wo, Wo, Wo, Wo, Wo, Ww, Dd, Ww, Wwf, Dd, Dd, Dd, Wwf, Rd^Vd, Dd, Ww, Ww, Wo, Ww, Wo, Ww, Wo, Ww, Wo, Wo, Wo, Wo, Wo
Wo, Wo, Wo, Wo, Wo, Wo, Ww, Wo, Ww, Ww, Dd, Wwf, Dd, Dd, Rd, Rd, Rd, Rd, Dd^Ftd, Dd, Wwf, Ww, Ww, Ww, Ww, Ww, Ww, Wo, Wo, Wo, Wo, Wo
Wo, Wo, Wo, Wo, Wo, Ww, Ww, Ww, Ww, Dd, Dd, Dd, Wwf, Dd, Cdr, Cdr, Gs^Ft, Wwf, Wwf, Dd, Dd, Wwf, Wwf, Dd, Dd, Dd, Ww, Ww, Wo, Wo, Wo, Wo
Wo, Wo, Wo, Wo, Ww, Ww, Dd, Ww, Wwf, Wwf, Dd, Dd, Wwf, Rd, Gs^Ft, Kdr, Cdr, Rd, Dd, Dd, Rd^Vd, Dd, Dd, Dd^Ftd, Dd, Ww, Ww, Ww, Wo, Wo, Wo, Wo
Wo, Wo, Wo, Ww, Ww, Ww, Dd, Wwf, Dd, Dd, Rd^Vd, Wwf, Dd, Gs, Gs^Ft, Cdr, Gs^Ft, Rd, Dd, Wwf, Dd, Rd, Hd, Dd^Ftd, Rd, Dd, Wwf, Ww, Ww, Wo, Wo, Wo
Wo, Wo, Ww, Ww, Wwf, Dd, Dd^Ftd, Dd, Wwf, Dd, Rd, Rd, Hd, Gs^Ft, Gs, Cdr, Dd, Dd, Dd^Ftd, Wwf, Mdd, Hd, Dd, Rd, Gs^Ft, Dd, Dd, Wwf, Dd, Ww, Wo, Wo
Wo, Wo, Ww, Dd, Dd, Dd^Ftd, Rd^Vd, Dd, Dd, Wwf, Rd, Mdd, Hd, Gs^Ft, Rd, Dd, Wwf, Wwf, Dd, Dd^Ftd, Hd, Dd, Wwf, Gs, Gs^Ft, Gs^Ft, Gs, Dd, Wwf, Ww, Ww, Wo
Wo, Wo, Ww, Ww, Dd, Dd^Ftd, Dd, Rd, Gs^Ft, Dd, Hd, Hd, Dd^Ftd, Rd, Wwf, Dd, Dd, Dd, Wwf, Dd, Dd, Dd, Wwf, Wwf, Gs^Ft, Gs^Ft, Gs^Ft, Dd, Dd, Ww, Ww, Wo
Wo, Ww, Dd, Wwf, Dd, Wwf, Rd, Gs, Gs^Ft, Gs^Ft, Rd, Dd^Ftd, Dd, Wwf, Dd, Wwf, Dd^Ftd, Dd, Dd, Wwf, Dd, Dd, Wwf, Gs, Gs^Ft, Gs^Ft, Rd, Dd, Dd, Dd, Ww, Wo
Wo, Ww, Ww, Dd, Dd, Wwf, Rd, Gs^Ft, Gs^Ft, Gs, Wwf, Dd, Wwf, Dd, Hd, Dd^Ftd, Mdd, Hd, Hd, Wwf, Rd^Vd, Wwf, Dd, Gs^Ft, Hd, Gs^Ft, Rd, Wwf, Dd, Wwf, Ww, Wo
Wo, Ww, Dd, Dd, Dd, Dd, Wwf, Gs^Ft, Rd, Wwf, Dd^Ftd, Dd, Wwf, Dd, Rd, Hd, Hd, Gs^Ft, Gs^Ft, Gs^Ft, Dd, Dd, Dd^Ftd, Hd, Dd, Hd, Rd^Vd, Dd, Wwf, Dd, Ww, Wo
Wo, Ww, Ww, Wwf, Dd, Dd^Ftd, Dd^Ftd, Wwf, Wwf, Rd^Vd, Dd^Ftd, Dd, Rd, Gs, Gs^Ft, Rd, Dd, Dd, Gs, Gs^Ft, Rd, Wwf, Rd, Dd^Ftd, Wwf, Rd, Dd, Dd, Ww, Ww, Wo, Wo
Wo, Wo, Ww, Ww, Dd, Dd^Ftd, Dd, Wwf, Wwf, Dd, Wwf, Wwf, Gs, Gs^Ft, Gs^Ft, Gs, Rd, Wwf, Wwf, Rd, Wwf, Dd^Ftd, Gs^Ft, Rd, Wwf, Rd, Dd, Wwf, Ww, Wo, Wo, Wo
Wo, Wo, Ww, Dd, Dd^Ftd, Hd, Hd, Dd, Dd, Dd, Dd, Wwf, Dd, Gs^Ft, Hd, Gs^Ft, Gs^Ft, Dd, Wwf, Wwf, Rd, Gs^Ft, Gs^Ft, Dd, Dd, Wwf, Dd, Wwf, Dd, Ww, Wo, Wo
Wo, Ww, Dd, Dd, Dd, Gs^Ft, Mdd, Hd, Dd, Wwf, Wwf, Dd, Hd, Hd, Mdd, Hd, Hd, Dd, Dd, Wwf, Wwf, Gs, Gs^Ft, Rd, Wwf, Wwf, Dd^Ftd, Dd^Ftd, Dd, Ww, Wo, Wo
Wo, Ww, Ww, Wwf, Dd, Gs^Ft, Hd, Hd, Hd, Dd, Rd, Rd, Hd, Hd, Wwf, Dd, Dd, Rd, Dd, Wwf, Rd, Gs^Ft, Gs^Ft, Rd, Wwf, Rd^Vd, Dd^Ftd, Dd, Ww, Ww, Wo, Wo
Wo, Ww, Ww, Dd, Dd, Dd^Ftd, Dd^Ftd, Dd, Rd, Gs^Ft, Gs^Ft, Gs, Rd, Wwf, Dd, Wwf, Dd, Rd, Rd, Wwf, Dd, Dd^Ftd, Dd, Dd, Dd, Dd^Ftd, Dd^Ftd, Wwf, Ww, Wo, Wo, Wo
Wo, Wo, Ww, Dd, Ww, Dd, Dd, Rd^Vd, Wwf, Rd, Gs^Ft, Gs^Ft, Gs, Wwf, Dd, Rd, Rd, Ce, Rd, Dd, Wwf, Dd, Wwf, Dd, Wwf, Dd, Dd, Dd, Ww, Wo, Wo, Wo
Wo, Wo, Wo, Ww, Ww, Wwf, Dd, Dd, Wwf, Wwf, Rd, Gs^Ft, Rd, Rd, Wwf, Dd, Rd, Ce, Ke, Ce, Dd, Ww, Ww, Ww, Ww, Dd, Ww, Dd, Ww, Wo, Wo, Wo
Wo, Wo, Wo, Ww, Ww, Dd, Wwf, Dd, Dd, Wwf, Wwf, Dd, Dd^Ftd, Wwf, Wwf, Dd, Rd^Vd, Rd, Rd, Ce, Ww, Ww, Wo, Wo, Wo, Ww, Wo, Ww, Wo, Wo, Wo, Wo
Wo, Wo, Wo, Wo, Ww, Ww, Dd, Dd, Dd, Dd, Dd, Dd^Ftd, Dd, Dd, Dd, Dd^Ftd, Dd, Dd, Ww, Dd, Ww, Ww, Wo, Wo, Wo, Wo, Wo, Wo, Wo, Wo, Wo, Wo
Wo, Wo, Wo, Wo, Wo, Ww, Dd, Wwf, Ww, Wwf, Dd, Dd, Wwf, Wwf, Dd, Dd, Dd, Ww, Ww, Ww, Ww, Wo, Wo, Wo, Wo, Wo, Wo, Wo, Wo, Wo, Wo, Wo
Wo, Wo, Wo, Wo, Wo, Ww, Ww, Ww, Ww, Ww, Ww, Dd, Ww, Ww, Ww, Ww, Ww, Ww, Wo, Wo, Wo, Wo, Wo, Wo, Wo, Wo, Wo, Wo, Wo, Wo, Wo, Wo
Wo, Wo, Wo, Wo, Wo, Wo, Wo, Wo, Wo, Wo, Ww, Ww, Ww, Ww, Wo, Ww, Wo, Ww, Wo, Wo, Wo, Wo, Wo, Wo, Wo, Wo, Wo, Wo, Wo, Wo, Wo, Wo
Wo, Wo, Wo, Wo, Wo, Wo, Wo, Wo, Wo, Wo, Wo, Wo, Wo, Wo, Wo, Wo, Wo, Wo, Wo, Wo, Wo, Wo, Wo, Wo, Wo, Wo, Wo, Wo, Wo, Wo, Wo, Wo
Wo, Wo, Wo, Wo, Wo, Wo, Wo, Wo, Wo, Wo, Wo, Wo, Wo, Wo, Wo, Wo, Wo, Wo, Wo, Wo, Wo, Wo, Wo, Wo, Wo, Wo, Wo, Wo, Wo, Wo, Wo, Wo
