Mm, Mm, Mm^Xm, Mm, Mm, Mm^Xm, Mm, Mm, Mm, Hh, Hh, Hh, Gd, Gd, Gd, Gd, Gll^Fp, Gd, Gd, Gd, Gd, Gd, Gd, Gd, Gd, Gll^Fp, Gll^Fp, Gll^Fp, Hh^Fp, Hh, Gll^Fp, Hh, Hh, Hh, Gd, Gd, Ss, Ss, Ww, Ww, Wo, Wo
Mm, Mm, Mm^Xm, Mm, Mm, Mm^Xm, Mm, Mm, Mm, Hh, Hh, Hh, Gd, Gd, Gd, Gll^Fp, Gll^Fp, Gll^Fp, Gd, Gd, Gd, Gd, Gd, Gll^Fp, Gd, Gll^Fp, Gll^Fp, Gll^Fp, Hh, Hh, Gll^Fp, Hh, Hh, Hh, Gd, Gd, Ss, Ss, Ww, Ww, Wo, Wo
Mm, Mm, Mm, Mm^Xm, Mm^Xm, Mm^Xm, Mm, Mm, Mm, Mm, Hh, Hh, Hh, Gd, Gll^Fp, Gll^Fp, Gll^Fp, Gll^Fp, Hh^Fp, Hh^Fp, Hh, Gll^Fp, Hh, Hh^Fp, Hh, Gd, Gs, Hh^Fp, Hh^Fp, Gll^Fp, Gll^Fp, Hh, Hh, Hh^Fp, Gs, Gd, Gd, Ss, Ss, Ww, Wo, Wo
Hh, Hh, Hh, Mm, Hh, Hh, Hh, Mm, Mm, Mm, Hh, Hh^Fp, Gll^Fp, Hh^Fp, Gll^Fp, Gll^Fp, Gll^Fp, Gll^Fp, Hh, Hh, Mm, Hh, Hh, Hh, Hh, Hh, Hh, Hh^Fp, Hh, Hh, Hh, Hh, Gs, Gs, Gll^Fp, Gs, Gd, Gd, Ss, Ww, Wo, Wo
Gd, Gd, Hh^Fp, Mm, Hh, Gd, Hh^Fp, Hh, Hh^Fp, Hh, Hh^Fp, Hh^Fp, Gll^Fp, Gd, Gd, Gd, Gd, Gd, Hh, Hh, Mm, Mm, Hh, Hh^Fp, Hh^Fp, Hh, Hh, Hh, Hh, Hh, Hh, Hh, Gs, Gll^Fp, Gll^Fp, Gll^Fp, Gd, Gd, Ss, Ww, Wo, Wo
Gd, Gd, Mm, Mm, Gd, Gll^Fp, Hh, Gll^Fp, Gll^Fp, Hh, Hh, Gll^Fp, Gll^Fp, Gd, Gs, Gs, Gd, Gd, Hh, Hh, Hh, Hh^Fp, Gll^Fp, Gll^Fp, Gll^Fp, Gll^Fp, Gs, Gd^Vo, Gs, Gs, Gs, Gs, Hh, Hh^Fp, Gll^Fp, Gll^Fp, Gd, Gll^Fp, Ss, Ww, Wo, Wo
Gd, Gd, Gd, Gd, Gd, Hh, Hh, Gll^Fp, Gs, Hh, Gs, Gs, Gs, Gd, Gs, Gd, Gll^Fp, Gll^Fp, Gll^Fp, Hh, Hh, Hh^Fp, Gll^Fp, Gll^Fp, Gd, Gd, Gs, Gs, Gd, Ce, Ke, Ce, Gs, Gs, Gs, Gd, Ss, Ss, Ww, Ww, Wo, Wo
Gs, Gs, Ce, Ce, Gs, Gll^Fp, Gs, Gs, Gs, Gs, Gs, Hh, Hh, Gs, Gd, Gd, Gll^Fp, Gll^Fp, Gd, Hh, Gll^Fp, Gll^Fp, Gs, Gd, Gs, Gs, Gd, Gd, Ss, Ce, Ce, Gd, Gd, Gs, Gs, Gd, Ss, Ss, Ww, Wo, Wo, Wo
Gs, Gs, Ce, Ket, Ce, Gs, Gs, Gs, Gs, Gs, Hh, Hh, Hh, Gs, Gs, Gll^Fp, Gs, Gs, Gs, Gd, Gd, Gs, Gs, Gs, Gd, Gd, Gd, Ss, Ww, Ww, Ww, Ss, Ss, Gs, Gs, Gs, Ss, Ww, Ww, Wo, Wo, Wo
Gs, Gs, Gg, Ce, Gs, Gs, Gs, Gs, Gll^Fp, Gll^Fp, Hh^Fp, Gll^Fp, Hh, Gd, Gd, Gs, Gll^Fp, Gll^Fp, Gs, Gs, Gs, Gs, Gs, Gd^Vo, Ww, Ww, Ww, Ww, Ww, Wo, Wo, Ww, Ww, Ww, Wwf, Wwf, Ww, Ww, Wo, Wo, Wo, Wo
Gd, Gd, Gd, Gd, Gd, Gs, Gd, Gs, Gll^Fp, Gll^Fp, Gd, Hh, Gd, Gd, Gd, Gd, Gd, Gd, Gd^Vo, Gs, Gd, Gd, Ww, Ww, Wo, Ww, Wo, Wo, Wo, Wo, Wo, Wo, Wo, Ww, Ww, Wwf, Ww, Ww, Wo, Wo, Wo, Wo
Ss, Ss, Ww, Gd, Gd, Gd, Gd, Gs, Gll^Fp, Gd, Gd, Gd, Gs, Gd, Ss, Gs, Gs, Gs, Ss, Gs, Ww, Gd, Ww, Wo, Wo, Wo, Wo, Wo, Wo, Wo, Wo, Wo, Wo, Wo, Ww, Ww, Ww, Wo, Wo, Wo, Wo, Wo
Ww, Ww, Ww, Ww, Ww, Ww, Ww, Gs, Gd, Gs, Ww, Ww, Ww, Ww, Wo, Ww, Ww, Ww, Ww, Ww, Wo, Ww, Wo, Wo, Wo, Wo, Wo, Wo, Ww, Wo, Wo, Wo, Wo, Wo, Ww, Wwf, Ss, Ww, Ww, Wo, Wo, Wo
Wo, Wo, Wo, Wo, Wo, Wo, Ww, Wwf, Ww, Ww, Wo, Wo, Wo, Wo, Wo, Wo, Wo, Wo, Wo, Wo, Wo, Wo, Wo, Wo, Wo, Wo, Ww, Ww, Ww, Ww, Wo, Wo, Ww, Ww, Gs, Rp^Vhcr, Gd, Ss, Ww, Wo, Wo, Wo
Wo, Wo, Wo, Wo, Wo, Wo, Ww, Wwf, Ww, Wo, Wo, Wo, Wo, Wo, Wo, Wo, Wo, Wo, Wo, Wo, Wo, Wo, Wo, Wo, Ww, Wo, Ss, Gs, Ww, Wo, Wo, Wo, Ww, Ss, Gd, Rp, Gd, Ss, Ww, Wo, Wo, Wo
Wo, Wo, Ww, Ww, Ww, Ww, Ww, Wwf, Ww, Wo, Wo, Wo, Ww, Ww, Ww, Ww, Ww, Ww, Ww, Wo, Ww, Ww, Ww, Ww, Gd, Ss, Ss, Ss, Ww, Wo, Ww, Ww, Ss, Ss, Gs, Rp, Rp^Vhcr, Ss, Gll^Fp, Ww, Ww, Ww
Ww, Ww, Gll^Fp, Ss, Gs, Ww, Wwf, Gs, Wwf, Ww, Ww, Ww, Gd^Vo, Ww, Gs, Ss, Gd, Ss, Gs, Ww, Gd, Gd, Gd, Gd, Chr, Ww, Ww, Ss, Ss, Ww, Ss, Ww, Ss, Gd, Rp, Rp, Gs, Gd, Gll^Fp, Gll^Fp, Ww, Ww
Gd, Gd, Gd, Gd, Gd, Gs, Gll^Fp, Wwf, Gd, Ww, Gd, Gs, Gd, Gs, Gs, Gd, Gll^Fp, Gd, Gll^Fp, Gs, Gd, Gd, Gd, Gd, Rp, Gd, Gs, Ss, Ss, Ss, Gd, Ss, Gd, Gd, Rp, Rp^Vhcr, Gs, Hh, Gd, Ss, Ww, Ww
Gd, Gd, Gd, Gd, Gll^Fp, Gd, Gs, Gs, Gs, Gll^Fp, Gd, Gd, Gd, Gd, Gd, Gll^Fp, Gll^Fp, Gll^Fp, Gs, Gll^Fp, Gll^Fp, Gs, Gs, Gs, Gs, Chr, Rp, Rp^Vhcr, Rp, Gd, Rp^Vhcr, Gd, Chr, Chr, Chr, Rp, Gs, Hh, Hh, Ss, Ww, Ww
Gd, Gd, Gd, Gll^Fp, Gll^Fp, Gs, Gd, Gs, Gd, Gs, Gs, Gs, Gs, Gd, Gs, Gll^Fp, Gs, Gs, Gs, Gll^Fp, Gs, Gs, Chr, Gs, Rp, Gs, Rp, Gs, Chr, Rp, Rp, Rp, Chr, Khr, Chr, Gs, Hh, Hh, Gll^Fp, Ss, Ww, Ww
Gll^Fp, Gll^Fp, Gll^Fp, Gll^Fp, Gs, Gs, Gd, Gd, Gd, Gs, Gs, Gs, Gs, Gs, Gs, Gs, Gd, Gll^Fp, Gll^Fp, Gs, Gs, Gs, Rp, Rp, Gs, Rp, Gs, Rp, Gd, Gd, Khr, Rp, Gs, Chr, Rp, Gs, Hh, Hh, Ss, Ss, Ww, Ww
Gll^Fp, Gll^Fp, Gll^Fp, Gll^Fp, Gll^Fp, Gs, Gd, Gd, Gs, Gs, Gs, Gs, Gs, Gs, Gd, Gs, Hh^Fp, Gll^Fp, Hh^Fp, Gll^Fp, Gs, Gs, Chr, Gs, Gll^Fp, Gs, Gs, Gd, Gs, Chr, Rp, Gd, Gd, Rp, Hh, Rp, Rp^Vhcr, Gd, Ss, Ww, Ww, Ww
Gll^Fp, Gll^Fp, Gll^Fp, Gll^Fp, Gd^Vo, Gs, Gll^Fp, Gd, Gd, Gs, Gs, Gd^Vo, Hh, Hh, Hh, Hh, Hh, Hh, Hh, Hh, Gs, Gs, Gs, Gs, Gd, Gd, Gd, Gd, Ss, Chr, Rp^Vhcr, Hh, Gs, Gd, Gd, Hh, Gd, Ss, Ww, Ww, Wo, Wo
Gll^Fp, Gll^Fp, Gll^Fp, Gll^Fp, Gll^Fp, Gll^Fp, Gll^Fp, Gd, Hh, Gs, Gs, Hh, Mm, Mm, Hh, Hh, Hh^Fp, Hh, Gll^Fp, Hh^Fp, Hh, Hh, Gs, Gs, Gs, Gd, Gs, Ss, Ss, Ss, Ss, Gd, Ww, Ss, Ww, Gs, Ww, Ww, Wo, Wo, Wo, Wo
Gll^Fp, Gll^Fp, Gll^Fp, Gll^Fp, Gll^Fp, Gll^Fp, Hh^Fp, Hh, Hh, Hh, Gs, Hh, Hh^Fp, Hh, Gd, Gll^Fp, Gll^Fp, Gll^Fp, Gll^Fp, Gll^Fp, Gs, Gs, Gd, Gs, Gll^Fp, Gd, Gs, Ss, Ww, Ww, Ww, Ww, Wo, Ww, Ww, Ww, Ww, Ww, Wo, Wo, Wo, Wo
Gd, Gd, Gd, Hh^Fp, Hh^Fp, Hh^Fp, Mm, Hh^Fp, Hh, Gd, Gs, Hh, Gll^Fp, Gll^Fp, Gs, Gs, Gs, Gs, Gs, Gs, Gd, Gd, Gd, Gll^Fp, Gll^Fp, Gll^Fp, Ss, Ss, Ww, Ww, Wo, Wo, Wo, Wo, Wo, Ww, Ww, Wo, Wo, Wo, Wo, Wo
Gd, Gd, Hh, Hh^Fp, Mm, Mm, Mm, Hh, Gd, Gd, Gs, Gs, Gll^Fp, Gll^Fp, Gs, Gs, Gd, Gd, Ss, Gd, Ss, Ss, Ss, Ss, Ss, Ss, Ww, Ss, Ww, Ww, Wo, Wo, Wo, Wo, Wo, Ww, Ww, Wo, Wo, Wo, Wo, Wo
Hh, Hh, Hh, Hh, Mm, Mm, Mm, Hh, Hh, Gs, Gs, Gs, Gs, Gs, Gd, Gd, Ss, Gd, Ss, Ss, Ww, Ss, Ww, Ww, Ww, Ww, Ww, Ww, Wwr, Wo, Wo, Wo, Ww, Wo, Wwr, Ww, Wo, Wo, Wo, Wo, Wo, Wo
Mm, Mm, Mm^Xm, Mm^Xm, Mm^Xm, Mm, Hh, Hh, Gs, Gs, Gs, Gs, Gs, Gll^Fp, Gd, Ss, Ss, Ss, Ww, Ww, Ww, Ww, Ww, Ww, Ww, Ww, Wo, Wwr, Wwr, Wo, Wwr, Ww, Ww, Wwr, Wwr, Ww, Wo, Wo, Wo, Wo, Wo, Wo
Mm, Mm, Mm, Mm, Mm, Mm, Hh^Fp, Hh^Fp, Gll^Fp, Gll^Fp, Gll^Fp, Gs, Gs, Gd, Ce, Gd, Ss, Ss, Ww, Ww, Wo, Ww, Wo, Ww, Wo, Wo, Wo, Wo, Wo, Wwr, Ss, Ss, Ww, Ww, Wwr, Wo, Wo, Wo, Wo, Wo, Wo, Wo
Mm, Mm, Hh^Fp, Hh, Hh^Fp, Hh, Hh^Fp, Hh, Gll^Fp, Gll^Fp, Gs, Gs, Gll^Fp, Ce, Ket, Ce, Gs, Ss, Wwr, Wwr, Wo, Wo, Wo, Wo, Wo, Wo, Ww, Ww, Ww, Ww, Gs, Gd^Vo, Ss, Ss, Wwr, Wo, Wo, Wo, Wo, Wo, Wo, Wo
Hh^Fp, Hh^Fp, Gll^Fp, Hh^Fp, Gll^Fp, Gll^Fp, Gll^Fp, Gs, Gd, Gs, Gd, Gll^Fp, Gll^Fp, Gd, Ce, Ce, Gs, Ww, Ww, Ww, Wwr, Wo, Wo, Wo, Wo, Ww, Ss, Ss, Gll^Fp, Ss, Gll^Fp, Hh, Ss, Wwr, Wo, Wo, Wo, Wo, Wo, Wo, Wo, Wo
Gll^Fp, Gll^Fp, Gll^Fp, Gll^Fp, Gll^Fp, Gll^Fp, Gd, Gd, Gd, Gs, Gs, Gll^Fp, Gll^Fp, Gd, Gd, Gd, Ww, Ww, Ss, Ww, Ww, Wwr, Wwr, Wwr, Ww, Ww, Ww^Bw\, Gll^Fp, Gs, Gd, Hh, Hh^Fp, Ss, Ww, Wo, Wo, Wo, Wo, Wo, Wo, Wo, Wo
Hh, Hh, Hh, Gll^Fp, Gd, Gd, Gd, Gd, Gd, Gs, Gd^Vo, Ss, Ss, Ss, Ww, Ss, Ww, Ss, Ww, Ww, Wo, Wwr, Wwr, Ww, Wwr, Ww, Ss, Gd^Vo, Gll^Fp, Hh, Hh^Fp, Ss, Ww, Wo, Wo, Wo, Wo, Wo, Wo, Wo, Wo, Wo
Hh, Hh, Gll^Fp, Gd, Gd, Gd, Gll^Fp, Gs, Ss, Ss, Ss, Ss, Ss, Ww, Wo, Ww, Wo, Wo, Wo, Wo, Wo, Wo, Wo, Wo, Wo, Ww, Ss, Ss, Ss, Ss, Ss, Ss, Wo, Wo, Wo, Wo, Wo, Wo, Wo, Wo, Wo, Wo
Hh^Fp, Hh, Gll^Fp, Gll^Fp, Gll^Fp, Gd, Gd, Gd, Ss, Ss, Ss, Ww, Ww, Ww, Ww, Wo, Wo, Wo, Wo, Wo, Wo, Wo, Wo, Wo, Wo, Ww, Ww, Ww, Ww, Ww, Wo, Wo, Wo, Wo, Wo, Wo, Wo, Wo, Wo, Wo, Wo, Wo
Hh^Fp, Hh^Fp, Gll^Fp, Gll^Fp, Gll^Fp, Gd, Gd, Gd, Ss, Ss, Ss, Ww, Ww, Ww, Ww, Wo, Wo, Wo, Wo, Wo, Wo, Wo, Wo, Wo, Wo, Wo, Wo, Wo, Wo, Wo, Wo, Wo, Wo, Wo, Wo, Wo, Wo, Wo, Wo, Wo, Wo, Wo
