Mm, Mm, Mm, Mm, Mm, Ww, Mm, Mm, Mm, Hh, Hh, Hh, Gg, Gg, Gg, Gs^Fp, Gs^Fp, Gs^Fp, Gg, Gg, Gg, Gg, Gs^Fp, Gs^Fp, Gs^Fp, Gs^Fp, Gs^Fp, Gs^Fp, Hh, Hh, Ww, Hh, Hh, Hh, Gg, Gg, Ww, Ww, Ww, Ww, Wo, Wo
Mm, Mm, Mm, Mm, Mm, Ww, Mm, Mm, Mm, Hh, Hh, Hh, Gg, Gg, Gg, Gs^Fp, Gs^Fp, Gs^Fp, Gg, Gg, Gg, Gg, Gs^Fp, Gs^Fp, Gs^Fp, Gs^Fp, Gs^Fp, Gs^Fp, Hh, Hh, Ww, Hh, Hh, Hh, Gg, Gg, Ww, Ww, Ww, Ww, Wo, Wo
Mm, Mm, Mm, Mm, Mm, Mm, Mm, Mm, Mm, Mm, Hh, Hh, Hh, Gg, Gs^Fp, Gs^Fp, Ww, Gs^Fp, Hh, Hh, Hh, Gg, Hh, Hh, Hh, Gs^Fp, Gg, Hh, Hh, Ww, Ww, Hh, Hh, Gg, Gg, Gg, Gg, Ww, Ww, Ww, Wo, Wo
Hh, Hh, Hh, Mm, Ce, Ce, Ce, Mm, Mm, Mm, Hh, Hh, Gs^Fp, Gg, Gs^Fp, Gs^Fp, Gs^Fp, Gs^Fp, Hh, Hh, Mm, Hh, Hh, Hh, Hh, Hh, Hh, Hh, Hh, Hh, Hh, Hh, Gg, Gg, Gs^Fp, Gs^Fp, Gs^Fp, Gg, Ww, Ww, Wo, Wo
Gg, Gg, Gg, Mm, Hh, Ket, Ce, Hh, Hh, Hh, Hh, Hh, Gs^Fp, Gs^Fp, Gs^Fp, Gg, Gg, Gg, Hh, Hh, Mm, Mm, Hh, Hh, Hh, Hh, Hh, Hh, Hh, Hh, Hh, Hh, Gg, Gs^Fp, Gs^Fp, Gs^Fp, Gs^Fp, Gg, Ww, Ww, Wo, Wo
Gg, Gg, Mm, Mm, Gg, Ce, Hh, Gs^Fp, Gs^Fp, Hh, Hh, Gs^Fp, Gs^Fp, Gs^Fp, Gs^Fp, Gg, Gg, Gg, Hh, Hh, Hh, Hh, Gs^Fp, Gs^Fp, Gs^Fp, Gs^Fp, Gg, Gg, Re, Re, Re, Gg, Hh, Hh, Gs^Fp, Gs^Fp, Gg, Gg, Ww, Ww, Wo, Wo
Gg, Gg, Gg, Gg, Gg, Hh, Hh, Gs^Fp, Gs^Fp, Hh, Re, Re, Re, Gs^Fp, Gg, Gg, Gs^Fp, Gs^Fp, Gs^Fp, Hh, Hh, Hh, Gs^Fp, Gs^Fp, Gg, Gg, Gg, Gg, Ce, Ce, Ce, Gg, Re, Gg, Gs^Fp, Gg, Ww, Ww, Ww, Ww, Wo, Wo
Gg, Gg, Re, Gg, Gg, Gg, Gs^Fp, Gs^Fp, Gs^Fp, Gs^Fp, Gg, Hh, Hh, Gg, Gg, Gs^Fp, Gs^Fp, Gs^Fp, Gg, Hh, Gg, Gs^Fp, Gs^Fp, Gs^Fp, Re, Re, Gg, Gg, Ww, Ke, Ce, Gg, Gg, Re, Gs^Fp, Gs^Fp, Ww, Ww, Ww, Wo, Wo, Wo
Re, Re, Gg, Re, Gg, Gg, Gg, Gs^Fp, Gs^Fp, Gs^Fp, Hh, Hh, Hh, Re, Re, Gs^Fp, Re, Re, Gg, Gg, Gg, Gg, Re, Re, Gg, Gg, Gg, Ww, Ww, Ww, Ww, Ww, Ww, Gg, Gs^Fp, Gs^Fp, Ww, Ww, Ww, Wo, Wo, Wo
Re, Re, Gg, Gg, Gg, Gg, Re, Re, Gs^Fp, Gs^Fp, Hh, Ww, Hh, Gg, Gg, Re, Gs^Fp, Gs^Fp, Gg, Gg, Gg, Re, Gg, Gg, Ww, Ww, Ww, Ww, Ww, Ww, Ww, Ww, Ww, Ww, Ww, Ww, Ww, Ww, Wo, Wo, Wo, Wo
Gg, Gg, Gg, Gg, Gg, Gg, Gg, Re, Gs^Fp, Gs^Fp, Gs^Fp, Hh, Gg, Gg, Gg, Gs^Fp, Gs^Fp, Gs^Fp, Gg, Gg, Gg, Gg, Ww, Ww, Wo, Ww, Wo, Wo, Wo, Wo, Wo, Wo, Wo, Ww, Ww, Ww, Wo, Ww, Wo, Wo, Wo, Wo
Ww, Ww, Ww, Gg, Gg, Gg, Gg, Re, Gg, Gs^Fp, Gs^Fp, Gs^Fp, Gg, Gg, Ww, Gg, Gg, Gg, Ww, Gg, Ww, Gg, Ww, Wo, Wo, Wo, Wo, Wo, Wo, Wo, Wo, Wo, Wo, Wo, Wo, Ww, Ww, Wo, Wo, Wo, Wo, Wo
Ww, Ww, Ww, Ww, Ww, Ww, Ww, Gg, Gg, Gg, Ww, Ww, Ww, Ww, Wo, Ww, Ww, Ww, Ww, Ww, Wo, Ww, Wo, Wo, Wo, Wo, Wo, Wo, Ww, Wo, Wo, Wo, Wo, Wo, Ww, Ww, Ww, Ww, Ww, Wo, Wo, Wo
Wo, Wo, Wo, Wo, Wo, Wo, Ww, Ww^Bw|, Ww, Ww, Wo, Wo, Wo, Wo, Wo, Wo, Wo, Wo, Wo, Wo, Wo, Wo, Wo, Wo, Wo, Wo, Ww, Ww, Ww, Ww, Wo, Wo, Ww, Ww, Ds, Ds, Ds, Ww, Ww, Wo, Wo, Wo
Wo, Wo, Wo, Wo, Wo, Wo, Ww, Wwf, Ww, Wo, Wo, Wo, Wo, Wo, Wo, Wo, Wo, Wo, Wo, Wo, Wo, Wo, Wo, Wo, Ww, Wo, Ww, Gg, Ww, Wo, Wo, Wo, Ww, Ww, Gg, Rr, Gg, Ww, Ww, Wo, Wo, Wo
Wo, Wo, Ww, Ww, Ww, Ww, Ww, Ww^Bw|, Ww, Wo, Wo, Wo, Ww, Ww, Ww, Ww, Ww, Ww, Ww, Wo, Ww, Ww, Ww, Ww, Gg, Ww, Ww, Ww, Ww, Wo, Ww, Ww, Ww, Ds, Gg, Rr, Gg^Vo, Ww, Gs^Fp, Ww, Ww, Ww
Ww, Ww, Gg, Ww, Gg, Ww, Ww, Wwf, Ww, Ww, Ww, Ww, Gg, Ww, Gg, Ww, Gg, Ww, Gg, Ww, Gg, Gg, Gg, Gg, Gg, Ww, Ww, Ww, Ww, Ww, Ds, Ww, Ds, Ds, Rr, Gg, Rr, Ds, Gs^Fp, Gs^Fp, Ww, Ww
Gg, Gg, Gg, Gg, Gg, Gg, Gg, Ww^Bw|, Ss, Ss, Ss, Ss, Gg, Gg, Gg, Gg, Gs^Fp, Gg, Gs^Fp, Gg, Gg, Gg, Gg, Gg, Gg, Ww, Ds, Ds, Ds, Ds, Rr, Ds, Gg, Gg, Gg^Vo, Gg, Rr, Hh, Ds, Ww, Ww, Ww
Gg, Gg, Gg, Gg, Gs^Fp, Gg, Gg, Gg, Ss, Ss, Ss, Ss, Gg, Gg, Gg, Gs^Fp, Gs^Fp, Gg, Gg, Gs^Fp, Gs^Fp, Gg, Gg, Gg, Gg, Gg, Co, Gg, Rr, Gg^Vo, Gg, Gg, Co, Co, Co, Rr, Gg, Hh, Hh, Ww, Ww, Ww
Gg, Gg, Gg, Gs^Fp, Gs^Fp, Gg, Gg, Gg, Gg, Ss, Ss, Gg, Gg, Gg, Gg, Gs^Fp, Gs^Fp, Gs^Fp, Gs^Fp, Gs^Fp, Gs^Fp, Gg, Gg, Gg, Gg, Gg, Re, Gg, Co, Gg, Gg, Rr, Co, Ko, Co, Gg, Hh, Hh, Ds, Ww, Ww, Ww
Gs^Fp, Gs^Fp, Gs^Fp, Gs^Fp, Gg, Gg, Gg, Gg, Gg, Gg, Gg, Gg, Re, Re, Re, Re, Gg, Gs^Fp, Gs^Fp, Re, Re, Gs^Fp, Re, Gg, Re, Re, Gg, Gg, Gg, Gg, Gg, Gg, Gg^Vo, Co, Rr, Gg, Hh, Hh, Ww, Ww, Ww, Ww
Gs^Fp, Gs^Fp, Gs^Fp, Gs^Fp, Gs^Fp, Gg, Gg, Gg, Ce, Ce, Ce, Gg, Gg, Gg, Gg, Gg, Hh, Gs^Fp, Hh, Gs^Fp, Gg, Re, Gg, Re, Gg, Gg, Gg, Gg, Gg, Co, Gg, Gg, Gg, Rr, Hh, Rr, Gg, Gg, Ww, Ww, Ww, Ww
Gs^Fp, Gs^Fp, Gs^Fp, Gs^Fp, Gg, Gg, Gs^Fp, Gg, Ce, Ket, Ce, Gg, Hh, Hh, Hh, Hh, Hh, Hh, Hh, Hh, Gg, Gg, Gg, Re, Gs^Fp, Gg, Gg, Gg, Ww, Co, Gg^Vo, Hh, Gg, Gg, Gg, Hh, Gg^Vo, Ww, Ww, Ww, Wo, Wo
Gs^Fp, Gs^Fp, Gs^Fp, Gs^Fp, Gs^Fp, Gs^Fp, Gs^Fp, Gg, Hh, Ce, Gg, Hh, Mm, Mm, Hh, Hh, Hh, Hh, Gs^Fp, Hh, Hh, Hh, Re, Re, Gg, Gg, Gg, Ww, Ww, Ww, Ww, Gg, Ww, Ww, Ww, Gg, Ww, Ww, Wo, Wo, Wo, Wo
Gs^Fp, Gs^Fp, Gs^Fp, Gs^Fp, Gs^Fp, Gs^Fp, Hh, Hh, Hh, Hh, Re, Hh, Hh, Hh, Gg, Gs^Fp, Gs^Fp, Gs^Fp, Gs^Fp, Gs^Fp, Re, Re, Gg, Gg, Gs^Fp, Gs^Fp, Gg, Ww, Ww, Ww, Ww, Ww, Wo, Ww, Ww, Ww, Ww, Ww, Wo, Wo, Wo, Wo
Gg, Gg, Gg, Hh, Hh, Hh, Mm, Hh, Hh, Gg, Re, Hh, Gs^Fp, Gs^Fp, Gs^Fp, Gg, Re, Re, Re, Gs^Fp, Gs^Fp, Gg, Gs^Fp, Gs^Fp, Gs^Fp, Gs^Fp, Ww, Ww, Ww, Ww, Wo, Wo, Wo, Wo, Wo, Ww, Ww, Wo, Wo, Wo, Wo, Wo
Gg, Gg, Hh, Hh, Mm, Mm, Mm, Hh, Gg, Gg, Gg, Re, Gs^Fp, Gs^Fp, Gg, Gg, Gs^Fp, Gg, Ww, Gs^Fp, Ww, Ww, Ww, Ww, Ww, Ww, Ww, Ww, Ww, Ww, Wo, Wo, Wo, Wo, Wo, Ww, Ww, Wo, Wo, Wo, Wo, Wo
Hh, Hh, Hh, Hh, Mm, Mm, Mm, Hh, Hh, Gs^Fp, Gg, Re, Re, Re, Gg, Gg, Ww, Gs^Fp, Ww, Ww, Ww, Ww, Ww, Ww, Ww, Ww, Ww, Ww, Ww, Wo, Wo, Wo, Ww, Wo, Ww, Ww, Wo, Wo, Wo, Wo, Wo, Wo
Mm, Mm, Mm, Mm, Mm, Mm, Hh, Hh, Gg, Gg, Gs^Fp, Gg, Re, Gg, Gg, Ww, Ww, Ww, Ww, Ww, Ww, Ww, Ww, Ww, Ww, Ww, Wo, Ww, Ww, Wo, Ww, Ww, Ww, Ww, Ww, Ww, Wo, Wo, Wo, Wo, Wo, Wo
Mm, Mm, Mm, Mm, Mm, Mm, Hh, Hh, Gg, Gg, Gs^Fp, Gg, Re, Gg, Gg, Ww, Ww, Ww, Ww, Ww, Ww, Ww, Ww, Ww, Ww, Ww, Wo, Ww, Ww, Wo, Ww, Ww, Ww, Ww, Ww, Ww, Wo, Wo, Wo, Wo, Wo, Wo
