Ms, Ms, Ms, Ms, Ms, Ha, Ha, Ha, Ha, Ha, Ms, Ai, Ha, Ha, Ms, Aa, Aa, Aa, Ww, Aa, Ai, Ww, Wo, Wo, Ai, Wo, Wo, Wo, Wo, Wo, Wo, Wo, Wo, Wo, Wo, Wo, Wo, Wo, Wo, Wo, Wo, Wo, Wo, Wo, Wo, Wo, Wo, Wo, Wo, Wo, Wo, Wo, Wo, Ww, Gg, Gg, Gs^Fp, Ss, Ss, Ss, Ss, Gg^Fp, Gg, Ww, Gg, Gs^Fp, Gs^Fp, Gs^Fp
Ha, Ha, Ha, Ms, Ms, Ha, Aa^Fpa, Aa^Fpa, Ha, Ms, Ha, Ha, Aa^Fpa, Aa, Aa, Aa, Ai, Ai, Wo, Ai, Wo, Wo, Ai, Wo, Wo, Wo, Wo, Wo, Wo, Wo, Wo, Wo, Wo, Wo, Wo, Wo, Wo, Wo, Wo, Wo, Wo, Wo, Ww, Wo, Ww, Wo, Ww, Wo, Wo, Wo, Wo, Wo, Wo, Ww, Ww, Gg, Ds, Gg^Fp, Ww, Gg^Fp, Ww, Gg^Fp, Ww, Ww, Gg, Gs^Fp, Gs^Fp, Gs^Fp
Aa, Aa^Fpa, Ha, Ms, Ha, Ha, Aa^Fpa, Aa^Fpa, Aa^Fpa, Ha, Ha, Aa^Fpa, Aa, Aa, Ai, Ww, Wo, Wo, Wo, Wo, Wo, Wo, Wo, Wo, Wo, Wo, Wo, Wo, Wo, Wo, Wo, Wo, Wo, Wo, Wo, Wo, Wo, Wo, Wo, Wo, Wo, Ww, Wo, Ww, Ww, Ww, Ww, Ww, Wo, Wo, Wo, Wo, Wo, Wo, Wo, Ww, Ww, Ww, Ch^Vhc, Ww, Gg, Ww, Gg^Fms, Gg^Fms, Gg, Gg, Gg, Gg
Aa, Aa, Aa, Aa, Aa, Aa, Aa, Aa, Ha, Ha, Ms, Ha, Aa, Aa, Ww, Wo, Wo, Wo, Wo, Wo, Wo, Wo, Wo, Wo, Wo, Wo, Wo, Wo, Ww, Wo, Wo, Wo, Ww, Ww, Ww, Ww, Ww, Wo, Wo, Wo, Wo, Wo, Wo, Ww, Ww, Gs, Hh, Ww, Ww, Wo, Wo, Wo, Wo, Wo, Wo, Wo, Wo, Ww, Ds, Gg, Gg, Gg, Gg, Gg, Re^Gvs, Re^Gvs, Re^Gvs, Gg
Ai, Ai, Ai, Ai, Aa, Aa, Ai, Aa, Ha, Ms, Ha, Ha, Ai, Ai, Wo, Wo, Wo, Wo, Wo, Wo, Wo, Wo, Ww, Wo, Wo, Wo, Wo, Ww, Ww, Ww, Ww, Wo, Ww, Gg^Fp, Gg^Vo, Ww, Wo, Wo, Wo, Wo, Wo, Wo, Wo, Wo, Ww, Gs, Gs^Vhr, Gs, Ww, Wo, Wo, Wo, Wo, Wo, Wo, Wo, Wo, Ww, Ww, Gg, Re^Gvs, Re^Gvs, Re^Gvs, Gg, Gg, Re^Gvs, Gg, Gg
Ww, Ww, Ww, Ai, Ww, Ai, Ww, Aa, Aa, Ha, Aa, Aa, Ww, Wo, Wo, Wo, Ww, Wo, Wo, Wo, Wo, Ww, Ww, Wo, Ww, Ww, Ww, Ww, Gg, Ww, Ww, Wo, Gg, Ds, Ww, Ww, Wo, Wo, Wo, Wo, Wo, Wo, Wo, Wo, Ww, Ss, Ss, Ww, Ww, Ww, Wo, Wo, Wo, Wo, Wo, Wo, Ww, Ww, Gg^Fms, Gg^Fms, Gg, Re^Gvs, Gg, Gg, Re^Gvs, Gg, Gg, Ch
Ww, Ww, Ww, Ww, Ww, Ww, Ww, Ai, Ww, Ai, Ai, Aa^Vla, Ww, Ww, Wo, Ww, Ww, Wo, Ww, Ww, Ww, Ww, Ww, Ww, Wo, Ww, Ww, Gg^Fp, Gg, Hh, Gg, Ww^Bw/, Ww, Gg^Fp, Ww, Wo, Wo, Wo, Wo, Wo, Wo, Wo, Ww, Ww, Gs^Ft, Ww, Ww, Ww, Gs, Ww, Ww, Wo, Wo, Wo, Wo, Ww, Ww, Ds, Gg, Gg^Fms, Ds, Gg, Gg, Re^Gvs, Re^Gvs, Re^Gvs, Gg, Gg
Ww, Wo, Ww, Ww, Wo, Ww, Wo, Wo, Wo, Ww, Ww, Ww, Wo, Wo, Ww, Ww, Ww, Ww, Gs, Gs^Ft, Gg^Ve, Gs, Ww, Ww, Wo, Wo, Ww, Hh, Gg^Fp, Ww, Ww, Ww, Ww, Ww, Wo, Wo, Wo, Wo, Wo, Wo, Wo, Wo, Ww, Ww, Ww, Gs, Ww, Ww, Ww, Ww, Ww, Wo, Wo, Wo, Wo, Ww, Ww, Ds, Ds, Ds, Ww, Ds, Ds, Gg, Gg, Gg, Gg, Gs^Fms
Ww, Ww, Ww, Ww, Ww, Wo, Wo, Wo, Wo, Wo, Ww, Ww, Ww, Wo, Wo, Ww, Ww, Ww, Ww, Hh, Ww^Bw|, Ww, Ww, Wo, Wo, Wo, Wo, Ww, Gg, Ww^Bw\, Ww, Ds, Ww, Wo, Wo, Ww, Ww, Wo, Wo, Wo, Wo, Wo, Wo, Wo, Wo, Ww, Ww, Gs, Ww, Ww, Wo, Wo, Wo, Wo, Wo, Ww, Ww, Ww, Ww, Ww, Ww, Ww, Ww, Ds, Ds, Gg, Gg, Gs^Fms
Gg, Gg, Gg, Ds, Ds, Ww, Wo, Wo, Wo, Wo, Wo, Wo, Wo, Wo, Wo, Wo, Wo, Wo, Ww, Ww, Gs, Gs, Ww, Wo, Wo, Wo, Wo, Ww, Ww, Ww, Ww, Ww, Ww, Ww, Ww, Ww, Ww, Wo, Wo, Wo, Wo, Wo, Wo, Wo, Wo, Wo, Wo, Ww, Wo, Ww, Ww, Ww, Wo, Wo, Wo, Wo, Ww, Ww, Wo, Ww, Ww, Ww, Wo, Ww, Ds, Gg, Gg, Gg
Hh, Hh, Hh, Gg, Gg, Ww, Ww, Ww, Ww, Wo, Wo, Wo, Wo, Wo, Wo, Wo, Wo, Wo, Ww, Gs, Hh, Ww, Hh, Ww, Wo, Wo, Wo, Wo, Wo, Wo, Wo, Wo, Wo, Wo, Ww, Gs^Ft, Ww, Wo, Wo, Wo, Wo, Wo, Wo, Wo, Wo, Wo, Wo, Wo, Ww, Ww, Gs, Ww, Wo, Wo, Wo, Ww, Ww, Ww, Ww, Wo, Wo, Wo, Wo, Ww, Ww, Ds, Gg, Gg
Hh, Mm, Hh, Gg, Gg, Ds, Ds, Ds, Ds, Ww, Wo, Wo, Wo, Wo, Wo, Wo, Wo, Ww, Gs, Gs, Gs^Ft, Mm, Gs, Ww, Ww, Wo, Wo, Wo, Wo, Wo, Wo, Wo, Ww, Ww, Ww, Ww, Ww, Ww, Ww, Ww, Wo, Wo, Ww, Ww, Ww, Ww, Ww, Ww, Ww, Gs, Hh, Ww, Wo, Wo, Wo, Wo, Ww, Ww, Gg, Ww, Wo, Wo, Wo, Wo, Ww, Ds, Gg, Gg
Gg^Fp, Gg^Fp, Gg^Fp, Gg, Gg, Gg^Fp, Gg^Fp, Gg, Ww, Ww, Wo, Wo, Wo, Wo, Wo, Wo, Wo, Ww, Ww, Ww, Ww, Ww, Ww, Ww, Wo, Wo, Wo, Wo, Wo, Wo, Wo, Ww, Gs^Ft, Ww, Ww, Gs^Ft, Wwf, Gs^Ft, Ww, Wo, Wo, Wo, Wo, Ww, Ww, Gs, Mm, Gs, Gs, Ww, Ww, Ww, Wo, Wo, Wo, Ww, Gg, Hh, Gs^Fds, Ww, Wo, Wo, Wo, Ww, Ds, Ds, Gg, Gg
Ss, Ss^Fp, Ss, Ww, Ww, Ww, Ww, Chw^Vhcr, Ww, Wo, Wo, Wo, Ww, Ww, Ww, Wo, Ww, Ww, Wo, Ww, Wo, Wo, Wo, Ww, Wo, Wo, Ww, Wo, Wo, Wo, Wo, Ww, Ww, Ww, Ww, Hh, Gs^Ft, Gs^Vd, Ww, Ww, Ww, Wo, Ww, Ww, Gs, Gs^Fp, Hh, Hh, Gs, Ww, Wo, Wo, Wo, Wo, Ww, Ww, Ww, Gg, Ww, Ww, Wo, Wo, Ww, Ww, Ds, Gg^Fms, Gg, Gg
Ss, Ss^Fp, Gg, Gg, Gg, Gg^Fp, Gg^Fp, Ww, Ds, Ww, Wo, Wo, Ww, Ww, Ww, Ww, Ww, Ww, Wo, Wo, Wo, Wo, Wo, Wo, Wo, Ww, Ww, Ww, Wo, Wo, Wo, Wo, Wo, Wo, Wo, Ww, Ww, Ww, Wo, Ww, Wo, Wo, Ww, Ww, Ww, Gs^Fp, Gs, Gs^Vo, Ww, Ww, Wo, Wo, Wo, Ww, Ww, Ww, Ww, Ww, Ww, Wo, Wo, Wo, Ww, Ds, Gg, Gg, Re^Gvs, Re^Gvs
Ww, Ww, Ww, Hh, Gg, Gg^Fp, Gg, Ds, Gg, Ww, Ww, Wo, Wo, Wo, Ww, Ww, Gs, Ww, Ww, Ww, Ww, Wo, Ww, Ww, Ww, Wo, Ww, Ww, Ww, Wo, Wo, Wo, Ww, Wo, Ww, Ww, Ww, Ww, Wo, Wo, Wo, Wo, Wo, Ww, Wo, Ww, Ww, Ww, Wo, Wo, Wo, Wo, Ww, Ww, Ds, Ds, Ds, Ww, Ww, Ww, Ww, Ww, Ds, Ds, Gg, Ch, Gg, Re^Gvs
Mm, Hh, Ww, Gg, Gg, Gg, Gg^Fp, Gg, Ds, Ds, Ww, Wo, Wo, Ww, Ww, Dd, Wwf, Gs^Ft, Dd, Ww, Ww, Wo, Wo, Ww, Ww, Ww, Gs, Gs, Ww, Wo, Wo, Wo, Ww, Ww, Ww, Gs^Ft, Ww, Wo, Wo, Wo, Wo, Wo, Wo, Wo, Wo, Wo, Wo, Wo, Wo, Wo, Ww, Ww, Gg, Ds, Gg, Gg, Gg, Gg, Gg, Ds, Gg, Ds, Gg, Gg, Re^Gvs, Gg, Gg, Gg
Hh, Hh, Gg, Ww, Ww, Gg^Fp, Ww, Gg, Ww, Ww, Wo, Wo, Ww, Ww, Ww, Gs^Ft, Dd, Wwf, Dd^Vdt, Ww, Wo, Wo, Ww, Ww, Ww, Gs, Gs, Gs^Ft, Ww, Ww, Ww, Ww, Ww, Gs^Ft, Ww, Ww, Ww, Ww, Ww, Ww, Ww, Wo, Wo, Wo, Wo, Wo, Wo, Wo, Wo, Wo, Ww, Ds, Gg, Gg, Gs^Fms, Gs^Fds, Gs^Fms, Gs^Fds, Gs^Fms, Gg, Gs^Fds, Gg, Gg, Re^Gvs, Re^Gvs, Re^Gvs, Gg, Gg
Gg, Gg, Gg, Gg^Fp, Gg^Fp, Wwf, Gg^Vo, Ww, Ww, Ww, Wo, Wo, Wo, Ww, Wo, Ww, Ww, Gs^Ft, Ww, Ww, Ww, Wo, Wo, Wo, Ww, Hh, Gs, Ww, Ww, Ww, Ww, Gs^Ft, Gs^Vhc, Ww, Ww, Ww, Gs^Ft, Ww, Ww, Ww, Ww, Wo, Wo, Wo, Wo, Wo, Wo, Wo, Wo, Ww, Ds, Gg, Gs^Fds, Gs^Fms, Gs^Fds, Gs^Fms, Gs^Fds, Gs^Fms, Gs^Fms, Gs^Fds, Gs^Fms, Gg, Gs^Fms, Gg, Gg, Gg, Re^Gvs, Re^Gvs
Ds, Ds, Ds, Gg^Fp, Ww, Gg, Ds, Ds, Ww, Wo, Wo, Wo, Wo, Wo, Wo, Ww, Ww, Ww, Wo, Ww, Wo, Wo, Wo, Wo, Ww, Hh, Hh, Gs^Ft, Hh, Gs, Gs, Gs, Gs^Ft, Gs, Ww, Ww, Ww, Ww, Wo, Ww, Wo, Wo, Wo, Wo, Wo, Wo, Wo, Wo, Ww, Ww, Gg, Gg, Gs^Fds, Gs^Fds, Gs^Fms, Cv^Fds, Kv^Fds, Cv^Fds, Gs^Fms, Gs^Fds, Gs^Fms, Gs^Fms, Gs^Fds, Gs^Fms, Gs^Fds, Gg, Gg, Re^Gvs
Ww, Ww, Ww, Ww, Ww, Ww, Ww, Ww, Wo, Wo, Wo, Wo, Wo, Wo, Wo, Wo, Wo, Wo, Wo, Wo, Wo, Wo, Wo, Wo, Wo, Ww, Ww, Ww, Gs, Hh, Gs^Ft, Hh, Hh, Gs, Gs^Ft, Ww, Ww, Wo, Wo, Wo, Wo, Wo, Wo, Wo, Wo, Wo, Wo, Wo, Ww, Ds, Gg, Gs^Fds, Gs^Fms, Gs^Fms, Gs^Fms, Gs^Fds, Gs^Fms, Gs^Fds, Gs^Fds, Gs^Fds, Gs^Fms, Gs^Fds, Cv^Fds, Gs^Fds, Gs^Fds, Gg, Gg, Gg
Ww, Ww, Ww, Ww, Ww, Ww, Ww, Ww, Wo, Wo, Wo, Wo, Wo, Wo, Wo, Wo, Wo, Wo, Wo, Wo, Wo, Wo, Wo, Wo, Wo, Wo, Wo, Ww, Gs, Hh, Gs^Ft, Hh, Hh, Gs, Gs, Ww, Ww, Ww, Wo, Wo, Wo, Wo, Wo, Wo, Wo, Wo, Wo, Wo, Ww, Ds, Gg, Gs^Fds, Gs, Cv^Fds, Gs^Fms, Gs^Fms, Gs^Fms, Gs^Fms, Cv^Fms, Gs^Fms, Gs^Fds, Gs^Fms, Gs^Fms, Gs^Fms, Gs^Fms, Gs^Fds, Gg, Gg
