Wo, Wo, Wo, Wo, Wo, Wo, Wo, Wo, Wo, Wo, Wo, Wo, Wo, Wo, Wo, Wo, Wo, Wo, Wo, Wo, Wo, Wo, Wo
Wo, Wo, Wo, Wo, Wo, Wo, Wo, Wo, Wo, Wo, Wo, Wo, Wo, Wo, Ww, Wo, Wo, Wo, Wo, Wo, Wo, Wo, Wo
Wo, Wo, Wo, Wo, Wo, Wo, Wo, Wo, Wo, Wo, Wo, Wo, Ww, Ww, Ce, Ww, Ww, Wo, Wo, Wo, Wo, Wo, Wo
Wo, Wo, Wo, Wo, Wo, Wo, Wo, Wo, Wo, Wo, Ww, Ww, Ce, Ce, Re^Vct, Ce, Ce, Ww, Ww, Wo, Wo, Wo, Wo
Wo, Wo, Wo, Wo, Wo, Wo, Wo, Wo, Wo, Wo, Ww, Ce, Re^Vct, Re, Ce, Re, Re^Vct, Ce, Ww, Wo, Wo, Wo, Wo
Wo, Wo, Wo, Wo, Wo, Wo, Wo, Wo, Ww, Ww, Rd, Ce, Re, Ce, Ket, Ce, Re, Ce, Ww, Wo, Wo, Wo, Wo
Wo, Wo, Wo, Wo, Wo, Wo, Ww, Ww, Rd, Rd, Re, Re, Re, Ce, Ce, Ce, Re^Vct, Ce, Ww, Wo, Wo, Wo, Wo
Wo, Wo, Wo, Wo, Ww, Ww, Rd, Rd, Re, Re, Re, Xom, Re, Re, Re^Vct, Re, Ce, Ce, Ww, Wo, Wo, Wo, Wo
Wo, Wo, Ww, Ww, Ce, Rd, Re, Re, Xom, Re, Re, Re, Rd, Ce, Ce, Ce, Ww, Ww, Wo, Wo, Wo, Wo, Wo
Wo, Wo, Ww, Ce, Re^Vct, Re, Re, Re, Re, Re, Rd, Rd, Ww, Ww, Ww, Ww, Ww, Ww, Ww, Wo, Wo, Wo, Wo
Wo, Wo, Ww, Ce, Re, Re, Re, Re, Rd, Rd, Ww^Bw\r, Ww^Bw|r, Wo, Wo, Ww, Ww, Ce, Ce, Ce, Ww, Ww, Wo, Wo
Wo, Wo, Ww, Ce, Ce, Re^Vct, Ce, Rd, Ww, Ww^Bw|r, Ww^Bw/r, Ww^Bw|r, Ww, Ww, Rd, Rd, Re, Re^Vct, Re, Ce, Ww, Wo, Wo
Wo, Wo, Wo, Ww, Ww, Ce, Ww, Ww, Wo, Ww^Bw|r, Ww^Bw\r, Ww^Bw|r, Rd, Rd, Re, Re, Xom, Re, Re^Vct, Ce, Ww, Wo, Wo
Wo, Wo, Wo, Wo, Wo, Ww, Wo, Wo, Ww, Ww^Bw|r, Rd, Rd, Re, Re, Re, Re, Re, Re, Ce, Ce, Ww, Wo, Wo
Wo, Wo, Wo, Wo, Wo, Wo, Ww, Ww, Re, Rd, Re, Re, Re, Xom, Re, Re, Rd, Rd, Ww, Ww, Wo, Wo, Wo
Wo, Wo, Wo, Wo, Wo, Ww, Ce, Ce, Re^Vct, Ce, Ce, Re, Re, Re, Rd, Rd, Ww, Ww, Wo, Wo, Wo, Wo, Wo
Wo, Wo, Wo, Wo, Wo, Ww, Ce, Re, Ce, Ket, Ce, Re, Rd, Rd, Ww, Ww, Wo, Wo, Wo, Wo, Wo, Wo, Wo
Wo, Wo, Wo, Wo, Wo, Ww, Ce, Re, Re, Re^Vct, Re, Rd, Ww, Ww, Wo, Wo, Wo, Wo, Wo, Wo, Wo, Wo, Wo
Wo, Wo, Wo, Wo, Wo, Ww, Ww, Ce, Ce, Ce, Ww, Ww, Wo, Wo, Wo, Wo, Wo, Wo, Wo, Wo, Wo, Wo, Wo
Wo, Wo, Wo, Wo, Wo, Wo, Wo, Ww, Ww, Ww, Wo, Wo, Wo, Wo, Wo, Wo, Wo, Wo, Wo, Wo, Wo, Wo, Wo
Wo, Wo, Wo, Wo, Wo, Wo, Wo, Wo, Wo, Wo, Wo, Wo, Wo, Wo, Wo, Wo, Wo, Wo, Wo, Wo, Wo, Wo, Wo
Wo, Wo, Wo, Wo, Wo, Wo, Wo, Wo, Wo, Wo, Wo, Wo, Wo, Wo, Wo, Wo, Wo, Wo, Wo, Wo, Wo, Wo, Wo
Wo, Wo, Wo, Wo, Wo, Wo, Wo, Wo, Wo, Wo, Wo, Wo, Wo, Wo, Wo, Wo, Wo, Wo, Wo, Wo, Wo, Wo, Wo
