Wo, Wo, Wo, Wo, Wo, Wo, Wo, Wo, Wo, Wo, Wo, Wo, Wo, Wo, Wo, Wo, Wo, Wo, Wo, Wo, Wo, Wo, Wo
Wo, Wo, Wo, Wo, Wo, Wo, Wo, Wo, Wo, Wo, Wo, Wo, Wo, Wo, Wo, Wo, Wo, Wo, Wo, Wo, Wo, Wo, Wo
Wo, Wo, Wo, Wo, Wo, Wo, Ww, Ww, Ww, Wo, Wo, Wo, Wo, Wo, Wo, Wo, Wo, Wo, Wo, Wo, Wo, Wo, Wo
Wo, Wo, Wo, Wo, Ww, Ww, Ce, Ce, Ce, Ww, Ww, Wo, Wo, Wo, Wo, Wo, Wo, Wo, Wo, Wo, Wo, Wo, Wo
Wo, Wo, Wo, Ww, Ce, Ce, Re, Re^Vct, Re, Ce, Ce, Ww, Wo, Wo, Ww, Ww, Ww, Wo, Wo, Wo, Wo, Wo, Wo
Wo, Wo, Wo, Ww, Ce, Re^Vct, Ce, Ce, Ce, Re^Vct, Ce, Ww, Ww, Ww, Ce, Ce, Ce, Ww, Ww, Wo, Wo, Wo, Wo
Wo, Wo, Wo, Ww, Ce, Re, Ce, Ket, Ce, Re, Ce, Ww, Ww, Ce, Re^Vct, Re, Re^Vct, Ce, Ww, Wo, Wo, Wo, Wo
Wo, Wo, Wo, Ww, Ce, Re^Vct, Re, Ce, Re, Re^Vct, Ce, Ww, Ww, Ce, Re, Re, Re, Ce, Ww, Wo, Wo, Wo, Wo
Wo, Wo, Wo, Ww, Ww, Ce, Re, Re, Re, Ce, Ww, Ww, Ww, Rd, Re, Xom, Re, Rd, Ww, Wo, Wo, Wo, Wo
Wo, Wo, Wo, Wo, Ww, Rd, Re, Xom, Re, Rd, Ww, Wo, Ww, Rd, Re, Re, Re, Rd, Ww, Wo, Wo, Wo, Wo
Wo, Wo, Wo, Wo, Ww, Rd, Re, Re, Re, Rd, Ww^Bw\r, Wo, Ww, Rd, Re, Re, Re, Rd, Ww, Wo, Wo, Wo, Wo
Wo, Wo, Wo, Wo, Ww, Rd, Re, Re, Re, Rd, Ww^Bw/r, Ww^Bw\r, Ww^Bw\r, Rd, Re, Xom, Re, Rd, Ww, Wo, Wo, Wo, Wo
Wo, Wo, Wo, Wo, Ww, Rd, Re, Xom, Re, Rd, Ww^Bw\r, Ww^Bw|r, Ww^Bw/r, Rd, Re, Re, Re, Rd, Ww, Wo, Wo, Wo, Wo
Wo, Wo, Wo, Wo, Ww, Rd, Re, Re, Re, Rd, Ww, Ww^Bw\r, Ww^Bw\r, Rd, Re, Re, Re, Rd, Ww, Wo, Wo, Wo, Wo
Wo, Wo, Wo, Wo, Ww, Rd, Re, Re, Re, Rd, Ww, Wo, Ww, Rd, Ce, Ce, Ce, Rd, Ww, Wo, Wo, Wo, Wo
Wo, Wo, Wo, Wo, Ww, Ce, Re^Vct, Re, Re^Vct, Ce, Ww, Wo, Ww, Re, Re^Vct, Ket, Re^Vct, Re, Ww, Wo, Wo, Wo, Wo
Wo, Wo, Wo, Wo, Ww, Ce, Ce, Re, Ce, Ce, Ww, Wo, Ww, Ce, Re, Ce, Re, Ce, Ww, Wo, Wo, Wo, Wo
Wo, Wo, Wo, Wo, Wo, Ww, Ww, Ce, Ww, Ww, Wo, Wo, Ww, Ce, Ce, Re, Ce, Ce, Ww, Wo, Wo, Wo, Wo
Wo, Wo, Wo, Wo, Wo, Wo, Wo, Ww, Wo, Wo, Wo, Wo, Wo, Ww, Ww, Ce, Ww, Ww, Wo, Wo, Wo, Wo, Wo
Wo, Wo, Wo, Wo, Wo, Wo, Wo, Wo, Wo, Wo, Wo, Wo, Wo, Wo, Wo, Ww, Wo, Wo, Wo, Wo, Wo, Wo, Wo
Wo, Wo, Wo, Wo, Wo, Wo, Wo, Wo, Wo, Wo, Wo, Wo, Wo, Wo, Wo, Wo, Wo, Wo, Wo, Wo, Wo, Wo, Wo
Wo, Wo, Wo, Wo, Wo, Wo, Wo, Wo, Wo, Wo, Wo, Wo, Wo, Wo, Wo, Wo, Wo, Wo, Wo, Wo, Wo, Wo, Wo
Wo, Wo, Wo, Wo, Wo, Wo, Wo, Wo, Wo, Wo, Wo, Wo, Wo, Wo, Wo, Wo, Wo, Wo, Wo, Wo, Wo, Wo, Wo
