Wo, Wo, Wo, Wo, Wo, Wo, Wo, Wo, Wo, Wo, Wo, Wo, Wo, Wo, Wo, Wo, Wo, Wo, Wo, Wo, Wo, Wo, Wo
Wo, Wo, Wo, Wo, Wo, Wo, Wo, Wo, Wo, Wo, Wo, Wo, Wo, Wo, Wo, Wo, Wo, Wo, Wo, Wo, Wo, Wo, Wo
Wo, Wo, Wo, Wo, Wo, Wo, Wo, Wo, Wo, Wo, Wo, Wo, Wo, Wo, Ww, Ww, Ww, Wo, Wo, Wo, Wo, Wo, Wo
Wo, Wo, Wo, Wo, Wo, Wo, Wo, Wo, Wo, Wo, Wo, Wo, Ww, Ww, Ce, Ce, Ce, Ww, Ww, Wo, Wo, Wo, Wo
Wo, Wo, Wo, Wo, Wo, Wo, Ww, Ww, Ww, Wo, Wo, Ww, Ce, Ce, Re, Re^Vct, Re, Ce, Ce, Ww, Wo, Wo, Wo
Wo, Wo, Wo, Wo, Ww, Ww, Ce, Ce, Ce, Ww, Ww, Ww, Ce, Re^Vct, Ce, Ce, Ce, Re^Vct, Ce, Ww, Wo, Wo, Wo
Wo, Wo, Wo, Wo, Ww, Ce, Re^Vct, Re, Re^Vct, Ce, Ww, Ww, Ce, Re, Ce, Ket, Ce, Re, Ce, Ww, Wo, Wo, Wo
Wo, Wo, Wo, Wo, Ww, Ce, Re, Re, Re, Ce, Ww, Ww, Ce, Re^Vct, Re, Ce, Re, Re^Vct, Ce, Ww, Wo, Wo, Wo
Wo, Wo, Wo, Wo, Ww, Rd, Re, Xom, Re, Rd, Ww, Ww, Ww, Ce, Re, Re, Re, Ce, Ww, Ww, Wo, Wo, Wo
Wo, Wo, Wo, Wo, Ww, Rd, Re, Re, Re, Rd, Ww, Wo, Ww, Rd, Re, Xom, Re, Rd, Ww, Wo, Wo, Wo, Wo
Wo, Wo, Wo, Wo, Ww, Rd, Re, Re, Re, Rd, Ww, Wo, Ww^Bw/r, Rd, Re, Re, Re, Rd, Ww, Wo, Wo, Wo, Wo
Wo, Wo, Wo, Wo, Ww, Rd, Re, Xom, Re, Rd, Ww^Bw/r, Ww^Bw/r, Ww^Bw\r, Rd, Re, Re, Re, Rd, Ww, Wo, Wo, Wo, Wo
Wo, Wo, Wo, Wo, Ww, Rd, Re, Re, Re, Rd, Ww^Bw\r, Ww^Bw|r, Ww^Bw/r, Rd, Re, Xom, Re, Rd, Ww, Wo, Wo, Wo, Wo
Wo, Wo, Wo, Wo, Ww, Rd, Re, Re, Re, Rd, Ww^Bw/r, Ww^Bw/r, Ww, Rd, Re, Re, Re, Rd, Ww, Wo, Wo, Wo, Wo
Wo, Wo, Wo, Wo, Ww, Rd, Ce, Ce, Ce, Rd, Ww, Wo, Ww, Rd, Re, Re, Re, Rd, Ww, Wo, Wo, Wo, Wo
Wo, Wo, Wo, Wo, Ww, Re, Re^Vct, Ket, Re^Vct, Re, Ww, Wo, Ww, Ce, Re^Vct, Re, Re^Vct, Ce, Ww, Wo, Wo, Wo, Wo
Wo, Wo, Wo, Wo, Ww, Ce, Re, Ce, Re, Ce, Ww, Wo, Ww, Ce, Ce, Re, Ce, Ce, Ww, Wo, Wo, Wo, Wo
Wo, Wo, Wo, Wo, Ww, Ce, Ce, Re, Ce, Ce, Ww, Wo, Wo, Ww, Ww, Ce, Ww, Ww, Wo, Wo, Wo, Wo, Wo
Wo, Wo, Wo, Wo, Wo, Ww, Ww, Ce, Ww, Ww, Wo, Wo, Wo, Wo, Wo, Ww, Wo, Wo, Wo, Wo, Wo, Wo, Wo
Wo, Wo, Wo, Wo, Wo, Wo, Wo, Ww, Wo, Wo, Wo, Wo, Wo, Wo, Wo, Wo, Wo, Wo, Wo, Wo, Wo, Wo, Wo
Wo, Wo, Wo, Wo, Wo, Wo, Wo, Wo, Wo, Wo, Wo, Wo, Wo, Wo, Wo, Wo, Wo, Wo, Wo, Wo, Wo, Wo, Wo
Wo, Wo, Wo, Wo, Wo, Wo, Wo, Wo, Wo, Wo, Wo, Wo, Wo, Wo, Wo, Wo, Wo, Wo, Wo, Wo, Wo, Wo, Wo
Wo, Wo, Wo, Wo, Wo, Wo, Wo, Wo, Wo, Wo, Wo, Wo, Wo, Wo, Wo, Wo, Wo, Wo, Wo, Wo, Wo, Wo, Wo
