Wo, Wo, Wo, Wo, Wo, Wo, Wo, Wo, Wo, Wo, Wo, Wo, Wo, Wo, Wo, Wo, Wo, Wo, Wo, Wo, Wo, Wo, Wo
Wo, Wo, Wo, Wo, Wo, Wo, Wo, Wo, Wo, Wo, Wo, Wo, Wo, Wo, Wo, Wo, Wo, Wo, Wo, Wo, Wo, Wo, Wo
Wo, Wo, Wo, Wo, Wo, Wo, Wo, Wo, Ww, Wo, Wo, Wo, Wo, Wo, Wo, Wo, Wo, Wo, Wo, Wo, Wo, Wo, Wo
Wo, Wo, Wo, Wo, Wo, Wo, Ww, Ww, Ce, Ww, Ww, Wo, Wo, Wo, Wo, Wo, Wo, Wo, Wo, Wo, Wo, Wo, Wo
Wo, Wo, Wo, Wo, Wo, Ww, Ce, Ce, Re, Ce, Re, Ww, Ww, Wo, Wo, Wo, Wo, Wo, Wo, Wo, Wo, Wo, Wo
Wo, Wo, Wo, Wo, Wo, Ww, Ce, Re, Ce, Re^Vct, Ce, Rd, Rd, Ww, Ww, Wo, Wo, Wo, Wo, Wo, Wo, Wo, Wo
Wo, Wo, Wo, Wo, Wo, Ww, Ce, Re, Re^Vct, Ket, Ce, Re, Re, Rd, Rd, Ww, Ww, Wo, Wo, Wo, Wo, Wo, Wo
Wo, Wo, Wo, Wo, Wo, Ww, Ww, Ce, Re, Ce, Re, Re, Re, Re, Re, Rd, Rd, Ww, Ww, Wo, Wo, Wo, Wo
Wo, Wo, Wo, Wo, Wo, Wo, Wo, Ww, Ww, Rd, Rd, Re, Re, Xom, Re, Re, Re, Rd, Ce, Ww, Ww, Wo, Wo
Wo, Wo, Wo, Wo, Ww, Ww, Ww, Wo, Wo, Ww^Bw|r, Ww^Bw/r, Rd, Rd, Re, Re, Re, Xom, Re, Re^Vct, Ce, Ww, Wo, Wo
Wo, Wo, Ww, Ww, Ce, Ce, Ce, Ww, Ww, Ww^Bw|r, Ww^Bw\r, Ww^Bw|r, Ww, Rd, Rd, Re, Re, Re, Re, Ce, Ww, Wo, Wo
Wo, Wo, Ww, Ce, Re, Re^Vct, Re, Rd, Rd, Ww^Bw|r, Ww^Bw/r, Ww^Bw|r, Wo, Ww, Ww, Rd, Ce, Re^Vct, Ce, Ce, Ww, Wo, Wo
Wo, Wo, Ww, Ce, Re^Vct, Re, Re, Re, Re, Rd, Rd, Ww^Bw|r, Ww, Wo, Ww, Ww, Ww, Ce, Ww, Ww, Wo, Wo, Wo
Wo, Wo, Ww, Ce, Ce, Re, Re, Re, Xom, Re, Re, Rd, Rd, Ww, Ce, Ww, Ww, Ww, Wo, Wo, Wo, Wo, Wo
Wo, Wo, Wo, Ww, Ww, Rd, Rd, Re, Re, Re, Re, Re, Re, Ce, Re^Vct, Ce, Ce, Ww, Ww, Wo, Wo, Wo, Wo
Wo, Wo, Wo, Wo, Wo, Ww, Ww, Rd, Rd, Re, Re, Xom, Re, Re, Ce, Re, Re^Vct, Ce, Ww, Wo, Wo, Wo, Wo
Wo, Wo, Wo, Wo, Wo, Wo, Wo, Ww, Ww, Rd, Rd, Re, Re, Ce, Ket, Ce, Re, Ce, Ww, Wo, Wo, Wo, Wo
Wo, Wo, Wo, Wo, Wo, Wo, Wo, Wo, Wo, Ww, Ww, Ce, Re^Vct, Ce, Ce, Ce, Re^Vct, Ce, Ww, Wo, Wo, Wo, Wo
Wo, Wo, Wo, Wo, Wo, Wo, Wo, Wo, Wo, Wo, Ww, Ce, Ce, Re, Re^Vct, Re, Ce, Ce, Ww, Wo, Wo, Wo, Wo
Wo, Wo, Wo, Wo, Wo, Wo, Wo, Wo, Wo, Wo, Wo, Ww, Ww, Ce, Ce, Ce, Ww, Ww, Wo, Wo, Wo, Wo, Wo
Wo, Wo, Wo, Wo, Wo, Wo, Wo, Wo, Wo, Wo, Wo, Wo, Wo, Ww, Ww, Ww, Wo, Wo, Wo, Wo, Wo, Wo, Wo
Wo, Wo, Wo, Wo, Wo, Wo, Wo, Wo, Wo, Wo, Wo, Wo, Wo, Wo, Wo, Wo, Wo, Wo, Wo, Wo, Wo, Wo, Wo
Wo, Wo, Wo, Wo, Wo, Wo, Wo, Wo, Wo, Wo, Wo, Wo, Wo, Wo, Wo, Wo, Wo, Wo, Wo, Wo, Wo, Wo, Wo
